escribe::intervening
unidireccional::importantly
constatamos::inadequate
impotente::feels
otro::another
turkmenistán::turkmenistan
resultando::underdeveloped
peticionario::petitioner
igual::equally
ciudades::cities
observadores::observers
participación::considerable
esperados::anticipated
regional::regional
psiquiátricas::psychiatric
oficialmente::weekend
compuesta::kyrgyz
compuesto::personalities
suceda::tragic
sucede::congress
acercamiento::libya
haber::have
trataría::instrument
judicial::judiciary
importantes::important
sabían::boots
tenía::keen
extenderse::push
trazar::agenda
esos::those
sobreproducción::mountains
canción::writer
infringen::cutbacks
dublín::dublin
patinete::customer
expresamente::expressly
vendido::meantime
importación::norwegian
desempeñan::assessments
parachoques::bull
fue::was
desempeñar::play
explorar::auditing
según::according
montaña::mountain
china::china
puñado::handful
provecho::advantage
chino::chinese
húngaro::sociology
querría::supported
valentín::stars
controles::controls
sospecha::suspicion
irlandeses::courts
divide::parts
ligera::lightly
battisti::battisti
otra::other
instalando::installed
niebla::fog
peluqueras::hairdressers
combinación::combination
constituyó::incarceration
sesiones::session
siguió::continued
críticas::criticisms
funciona::works
posteriormente::subsequently
encuentros::sports
miren::look
ambiciosos::scoreboard
trágicos::instability
tendrían::sooner
haberme::chamber
paliativos::vague
concepto::concept
pacífica::cambodia
temas::issues
convirtieron::separate
impartiendo::musicians
salvamento::agonising
impasibles::helpless
fabricantes::lowered
seremos::prepared
etiqueta::surrounding
derivados::derivatives
absoluto::about
unió::icc
absoluta::absolute
recién::newborn
reforma::reforming
crítico::thanking
cielo::sky
constituye::catastrophic
crítica::critical
podrían::even
mediante::through
ahorrado::great
hoy::today
caldo::seedbed
competitividad::competitiveness
ejemplar::germans
checos::czech
constante::striving
activistas::activists
deterioro::mysterious
sede::prominent
calidad::quality
seda::wrap
sería::would
comparto::share
eslovacos::slovaks
sentir::ashamed
secretos::fazakas
algunos::some
acabo::just
líneas::lines
pegado::politician
cerrada::locked
dejen::vain
víctimas::victims
cerrado::closed
jurado::jury
baratos::proceedings
reitero::napolitano
virgen::unspoilt
ruedas::wheelchair
prácticamente::virtually
presupuestos::friday
condado::illness
vertedero::mount
permitirá::analyses
surgir::amr
justificación::inevitability
océano::ocean
amenazado::threatened
entrañar::comprehensible
amenazada::cappato
estocolmo::stockholm
incluyen::mirrors
abordar::address
xx::twentieth
representa::represents
particulares::upsurge
represento::represent
angola::angola
americanas::films
funcionamiento::immune
financiar::finance
posgrado::graduate
clases::concealing
invitaría::names
interrumpido::speaker
urbano::urban
natatorios::cm
plantear::avenues
huellas::rathenov
ro::ro
reconocimiento::yellow
aprovecharlos::benefiting
amenaza::threat
correcta::direction
correcto::correct
pertenecía::fassbinder
hablaba::flemish
estable::stable
vacunas::experiments
migratorios::migratory
recomendaciones::recommendations
vergüenza::shame
adónde::absurd
apuntan::invite
especialistas::ernst
tantos::hidden
creatividad::reliance
interpretan::cutbacks
excepción::vague
esté::happy
xii::sorbonne
esenciales::disappear
casamanca::casamanca
eficiencia::efficiency
rechazando::rejecting
xix::nineteenth
inocentes::destitute
detractores::advocates
dogmatismo::dogmatism
abrazado::espoused
entra::enter
simplificados::simplified
responsabilidades::responsibilities
popularidad::popular
capacitación::enabling
ahmed::ahmed
griegas::greek
citando::fingers
tren::passengers
diario::dover
haya::hague
recurran::catches
tres::three
imposición::hotly
oponemos::selling
este::this
esta::this
pesada::competing
fundamentos::foundation
ratificación::ratification
esto::this
deliberaciones::discussions
duermen::stone
décima::tenth
pacientes::patients
sitio::website
gripe::pigs
números::telephone
campaña::campaign
captar::se
absorben::sucked
menudo::often
conceder::shape
nuevos::new
celebren::implemented
tipo::sort
médicos::doctors
mentalidad::philosophies
referido::altogether
haría::newspapers
mensaje::message
presenté::invade
aliado::discarded
estrasburgo::strasbourg
represión::repression
unificada::rathenov
esclavos::perform
sentidos::irony
qaeda::qaeda
incluso::even
ofrecerá::reasonable
firmarla::signing
pnb::bc
combinado::combined
buque::planned
concerniente::greenhouse
estuvo::accompanied
detalles::details
rico::wealthy
alimentarias::fed
peleo::scourge
rica::rich
relacionar::warming
plata::silver
últimas::recent
afganistán::afghanistan
ocuparé::dealt
consideradas::inadmissible
sustituir::replacing
caribe::caribbean
hierro::iron
concentrarse::base
digamos::carry
perros::dogs
modernas::broadband
comprar::buy
óptimas::perspective
compran::buy
abordadas::fingerprints
sueños::wreckage
bacalao::cod
guerra::war
franceses::french
erika::erika
ahorrar::consumed
vacaciones::surveys
altamente::asia
imaginarse::imagine
sueco::defect
tengamos::pioneers
desempleo::unemployment
destruidos::destroyed
ira::ira
glasgow::glasgow
alguien::someone
debo::standpoint
debe::must
envían::send
vídeo::shenanigans
meridional::caucasia
sras::sars
advertir::sets
macedonia::macedonia
patentes::eventually
administrativos::simplified
potencial::potential
actitud::attitude
colaboración::cooperation
cuadrados::square
lanzamiento::lift
territorio::territory
vais::sötét
tarea::task
escalada::sudan
doméstica::domestic
española::recognises
cometieron::repeated
tóxicos::gases
avisado::sinclaire
conocidas::counter
ministerios::ministries
ariane::ariane
cuna::cot
dirigen::aimed
apoyaremos::bold
gobierno::government
atasco::centralised
caída::fall
chile::chile
alega::referendums
caído::walls
medida::measure
sanitario::health
corán::koran
asegura::pflüger
sanitaria::abroad
cultivan::ugandan
importancia::importance
formas::belonging
abusar::goodwill
unos::few
ideológica::inflexibility
juegan::play
recursos::resources
cánceres::occupational
dudoso::doubtful
discurso::speech
contribuido::contributed
europeas::irrespective
iniciarse::must
big::bang
agencias::worker
sumatra::sumatra
frágiles::unseaworthy
combatir::reducing
memoria::remind
mujeres::women
buscando::looking
pescar::mauritian
primicia::puts
guineano::guinean
perjudicados::neglected
donante::donor
restringiendo::restricting
conexión::established
academia::sciences
frutos::foreseeable
prometo::stay
encaminados::immune
preparando::preparations
consecuencias::consequences
destacar::underline
cadenas::chains
comprendidas::involve
explota::exploited
han::have
trono::ukip
mencioné::list
hay::there
has::olivier
entero::ambitious
clonación::cloning
concretamente::integrated
municipal::serving
seductor::realistic
posee::homeless
exigente::assignment
pioneros::pioneers
aprovechar::shipowners
abandonar::leave
ninguna::no
chelines::ugandan
ninguno::claim
creen::upsurge
ola::wave
ocasión::occasion
septentrional::caucasus
olp::seventies
gustaba::bet
creer::ability
baratas::cheaper
pensemos::destructiveness
desarrollaremos::further
menciona::mentions
lluvias::sumatra
jugador::rotten
inmediata::immediate
inmediato::immediate
refieren::referring
cantidades::quantities
delito::crime
dougezhuang::municipal
montañas::scare
profesión::physiotherapists
rieron::laughed
o::or
información::information
entrante::incoming
optado::precedence
insolvencia::insolvency
abundancia::practise
militarmente::superpower
marshall::kalanke
sol::sun
son::are
soy::am
refugiados::refugees
facilita::exchanging
desconoce::defeat
proteccionista::protectionism
desprende::glean
democráticas::silence
sólidas::foundation
halla::located
joseph::joseph
colosales::colossal
humanos::human
kalanke::kalanke
sufran::enthusiasts
varsovia::warsaw
ellos::them
voluntarias::designations
normales::dusk
vesubio::mount
cubrirá::plug
talento::talented
verde::rapidly
ensayo::clinical
convencida::convinced
pesc::prospects
pese::seems
subvención::subsidy
albinos::babies
logró::annexed
pesos::lightweights
alguna::contributed
orillas::excess
liberal::liberal
violaciones::violations
condenar::condemn
albanesas::denounce
minas::mine
cometan::likelihood
liberar::syrian
prometen::turns
oficinas::offices
leer::read
inmensas::massive
actor::actor
encontrado::scorn
republic::rightly
cercanos::experienced
conseguirá::secular
prescindir::discarded
efectuado::cia
sacamos::apparent
contactos::counter
modelo::model
transportes::transport
tendencia::trend
escaño::seat
domingo::sunday
logro::achievement
incluida::protocol
puse::seaside
duros::punishments
incluido::cold
puso::revealed
sentimiento::belonging
considerado::hospital
observatorio::cable
entrevista::interview
fusión::fusion
rusos::russian
emisiones::emissions
diciembre::december
destitución::removed
distinguir::distinguish
ver::see
cerebros::brain
dedicados::traces
vez::time
trivial::trifling
inventariado::asset
salido::matches
decir::say
derechos::rights
ven::see
veo::regard
fragmentación::fragmentation
negociación::forecasts
egipcia::hoped
caos::haiti
minuto::chairmen
vendiendo::derivatives
puntualmente::must
indicios::underdeveloped
comisario::commissioner
comisaria::commissioner
eliminar::philosophies
afirmó::commissioner
querer::wanting
agentes::copies
cuotas::quotas
siga::avoid
soviéticos::turned
gratuitas::exhibitions
boca::mouths
actúe::incomprehensible
pienso::full
desafío::challenge
cubren::surface
piensa::alternatives
votaremos::electronic
vengo::luxembourg
desperdicios::growing
previsto::scheduled
referimos::plays
impuesto::imposed
vacías::empty
principales::main
fijaron::goal
brillante::rio
llevársela::leave
viaja::wind
viaje::coach
militar::military
afirma::contains
reforzado::reinforced
modernos::equivalent
abordados::assured
financiera::financial
financiero::financial
provocado::defect
llegase::arising
localizar::investigations
indefinidamente::carry
sistemas::systems
coordinada::professional
vínculo::link
explosión::o
fake::fake
explícitos::ham
mejora::improvement
positivo::positive
llegó::arrived
borrador::draft
rayos::sun
positiva::positive
indica::volcano
curioso::remarkably
únicos::ones
mayoría::majority
beneficio::profit
dedicaban::fished
bicicleta::customer
termal::allianoi
ovino::sheep
cuanto::strides
desea::ready
diagnosticada::diagnosed
valores::values
sé::know
priva::detained
sí::itself
empleados::employees
problemas::problems
desproporción::disproportion
modificaciones::changes
tabernero::innkeeper
rurales::rural
naturalmente::naturally
apostar::bet
incrementar::lines
apunta::unmarried
conviven::together
caña::restricted
dividen::split
fronterizos::freely
kenia::kenya
innegable::undeniable
llega::coming
acontecimiento::saa
risas::laughter
data::concept
natural::natural
controlar::check
sr::mr
área::limerick
su::its
truco::trick
colonia::cologne
si::if
cargadores::chargers
mezcla::mixed
flagrantes::blatant
conversión::vehicle
carteras::portfolios
principio::principle
magos::christmas
kong::hong
citado::quoted
transplante::transplant
músicos::musicians
cólera::ire
cotonú::cotonou
castigos::punishments
constituyen::discussed
ganamos::gain
esencialmente::essentially
jugando::playing
sentimos::verge
entrado::force
museo::museum
asignación::determines
concreción::closer
entrada::entry
condolencias::athens
referir::illegally
temen::dread
crédito::credit
asesinar::arson
integran::integrate
encontrados::mixed
pesados::lightweights
relacionados::cia
mañana::tomorrow
resultaron::seriously
determinar::truly
sepan::quebec
populares::flooding
fitosanitarios::plug
caminar::walking
prisma::prism
niños::children
honduras::honduras
bovino::beef
nacionales::national
atravesando::restore
organizar::organise
proclama::civilized
caramelos::sweets
parís::stopover
preventivas::orleans
alergias::packet
internet::internet
directivas::directives
portadores::ability
prohibiciones::bans
biotecnología::diabetic
tienen::have
huevos::disposed
variedades::académie
criminales::criminals
convocan::demonstrations
lucrativo::lucrative
brasil::realities
inferiores::ashamed
propios::own
funcionó::slowly
culturales::cultural
sanidad::measures
horas::hours
estrecho::straits
mucha::many
encuestas::show
ong::ngos
mucho::much
voto::vote
falsos::trumped
enemigo::enemy
intelectuales::madrid
ayudará::help
onu::resigning
gamberros::hooligan
estrecha::portuguese
están::are
funcionarán::ventures
axiología::morality
empiezan::smokers
procediendo::dictated
cito::quote
cita::quotation
designación::partnerships
programas::programmes
diputados::members
convincente::convincing
surgen::impoverishment
terroristas::terrorist
futura::shaping
bauer::bauer
futuro::future
desplazaba::user
producía::originally
cuesta::cost
reclamar::buzek
avanzamos::thither
san::san
aceptada::partnerships
siendo::still
votó::voted
aceptado::respective
burundi::burundi
construido::section
sediento::glass
arregla::your
estamos::are
eficaces::basic
coincide::commences
humanas::saved
asistentes::assistants
bucarest::section
barómetros::centuries
perdieron::injured
religiones::religions
termómetros::veterinary
debamos::maybe
merece::deserves
uranio::uranium
acabada::personalities
vasto::wide
serie::series
sala::room
desperdiciaría::wasted
acabado::cheap
occidental::jerusalem
legalización::expansion
dolor::controversy
cobre::cableway
cobro::promised
cortina::iron
armarios::unused
antiisraelí::marshall
igualdad::equality
fibra::controversial
dramática::fatah
negociaciones::negotiations
opuso::actively
hermanos::brotherhood
recalca::ernst
llave::locked
reiteradamente::repeatedly
simpáticos::uranium
llevadas::irrespective
época::protectionism
fe::faith
correcciones::corrections
adoptadas::compliance
temporada::warmer
prototipo::injudicious
venden::via
contenido::accurately
sureste::asia
ininterrumpido::uninterrupted
vender::selling
punta::gunpoint
geográfica::geographic
punto::point
ue::eu
atrapa::caught
recalcó::documentary
desleal::unfair
embrión::bioethics
universitaria::interview
filipinas::philippines
requieren::require
corriente::accusations
celebrar::celebrating
adultos::adults
daños::damage
nápoles::investigators
celebran::exhibitions
harán::fewer
mano::racism
considero::proponent
refiero::refer
refiere::concerns
droga::drugs
considera::believes
mostrarse::surprised
ante::blind
entregas::cia
reforzarse::sake
presentación::testimonials
ejército::army
conciudadanos::cured
tomen::enterprises
detrás::behind
personas::people
recibiendo::receiving
intelectual::infringement
javier::javier
observa::noted
observo::note
former::rightly
implique::religions
fin::end
título::physiotherapists
produjeron::soil
negligentes::enforcing
barata::exploited
tropezamos::hit
ascenso::inadmissible
iva::nauseam
contundente::definite
residentes::temporarily
nombramiento::appointment
angustioso::agonising
perseguido::persecuted
consideró::accidents
viento::wind
corregir::correct
damos::incoming
partenón::sculptures
siglo::century
sucedido::actually
putin::putin
observó::observed
suficientes::sufficient
muestra::intends
confirmado::justified
reaccionar::customary
contemplar::wreckage
continuación::continuation
transgénicas::académie
costa::santa
ínfima::occupational
normalidad::madeira
coste::cost
estatal::state
reflejado::reflected
dactilares::fingerprints
costo::emphasises
emitiendo::cannabis
vean::fewer
árabes::arab
falsificación::falsifying
participé::hearing
hadep::hadep
informaciones::register
chapuzas::botched
verdad::true
atraídos::computers
participó::participated
federación::federation
desproporcionadamente::lorries
sostuvo::affirmed
científicas::scientific
hacemos::doing
colegio::normally
preguntan::wonders
aprobación::adoption
usamos::equivalent
aspecto::aspect
plurianual::multiannual
suma::adds
líder::conservative
º::forefront
término::term
enero::january
localización::traceability
explicaciones::explanations
funciones::regulate
además::addition
inter::insurgence
participe::participation
pakistán::pakistan
financió::financed
ganancias::earnings
pregunten::ask
patrimonio::assets
definir::wailing
democracias::democracies
cannabis::cannabis
intervenir::speak
ampliaciones::embarking
perfectamente::ronald
degollado::stunned
cigarrillos::logo
ataques::attacks
ofrecen::accredited
ofrecer::offer
dará::precedent
parlamentos::parliaments
mossad::dubai
heridos::injured
película::film
johnston::johnston
estarán::sale
discapacidad::disabilities
recorrido::brilliant
niñas::girls
asamblea::house
cuestiones::issues
ayuda::aid
suprarregional::supraregional
intentándolo::trying
aguas::waters
lanzar::preparatory
matrimonio::stoning
italia::italy
abandonado::abandoned
satisfactoria::cured
comerciales::trade
completa::ce
irán::iran
aumentado::popular
largos::lacks
pistas::stone
ambigüedad::ambiguity
completo::completely
continente::continent
alemania::germany
clones::clones
radicalización::radicalisation
ruso::russian
rusa::russian
cerradas::shut
institución::institution
prohíben::banning
propias::denounce
crear::create
cuestión::issue
desaparecieran::ensure
oostlander::oostlander
rechazarse::bauer
ah::oh
ak::ak
al::the
mundo::world
izquierdas::listen
crean::pointless
básica::basic
subsidiariedad::subsidiarity
abstinencia::choice
remunerada::remunerated
pedir::ask
pierden::slow
secuencia::sequence
conectado::telephone
desdichadas::insufficient
inventar::invent
acreditadas::accredited
completó::serbia
congreso::congress
tendría::wait
relectura::delors
cpi::icc
posible::possible
masa::occurrence
precedieron::preceding
parejas::pairs
página::contractor
todavía::yet
tranquilidad::buried
quedará::tendering
preliminar::initiated
cámara::house
asientos::rico
azufre::sulphur
donantes::donors
respondido::allocation
pasó::hungary
prejuicio::racism
mezclar::confuse
imagínense::imagine
páginas::pages
jugadores::players
aplican::rels
to::what
legalidad::honesty
aplicar::survivors
acudieron::wasted
te::you
barroso::barroso
industrializado::bc
llegue::decisions
arreglado::managed
inclusión::decade
votaciones::gifts
cerdo::pork
organizador::counter
peor::worse
acababa::occupying
redundará::ultimately
retos::challenges
larga::long
esparadrapo::derogation
sana::healthy
largo::long
waldner::waldner
efectivamente::regulating
habrá::just
pase::obligatory
empezaré::personal
pasa::running
orador::speaker
paso::step
manifiesta::adds
hice::handles
ablandadores::plasticisers
definido::defined
argumentos::arguments
protestas::trace
comisarios::prodi
potencia::engine
ejercicios::occasional
llegué::flemish
transfronterizas::tenders
estatuas::commemorate
transportan::repulsive
reprocharle::compatriots
aquello::contempt
superficie::immense
aquella::taseer
activas::tricks
refuerza::governance
deportistas::ribbon
subversión::jiamusi
socias::comprehensive
osce::osce
transparente::clarity
pico::p
social::social
raza::radicalisation
colaboradores::sinclaire
rigurosos::rigorous
desastrosa::sorry
desastroso::fiasco
vih::hiv
influyen::gifts
vio::workload
depara::tackled
corto::short
corta::actual
corte::cambodia
solicitadas::respective
matado::fattened
camareras::gardens
carecemos::spare
minorías::minorities
objetivo::objective
conocen::local
diferente::different
pequeños::small
careceremos::foundation
ciencia::science
laeken::laeken
pudieran::ribbon
explotada::illegally
permítame::académie
normativa::inadequate
bajas::low
bajar::haiti
ejecución::execution
regulación::regulation
malo::bad
universitarios::graduate
leyes::laws
politkovskaja::liquidated
belga::belgian
mala::bad
delicada::sensitive
logran::rigorous
densamente::forthcoming
delicado::reputation
lesotho::lesotho
jornadas::naturally
cajas::via
lograr::achieve
impacto::impact
estudiado::automobile
totalitario::totalitarian
delegación::delegation
lejos::far
hugo::politicisation
volvió::participated
nación::nation
reyes::christmas
arranque::cold
podremos::shall
quisiera::like
plano::standpoint
nacimiento::produced
estuviéramos::embarking
encargarían::ensure
taxativos::scientific
birmania::burma
fundamental::fundamental
frases::here
signo::ribbon
personalmente::witnessed
papel::role
penales::unblemished
seguras::ruins
está::is
digan::want
pronto::early
buscan::divide
inflexibles::punishments
requisitos::indicated
buscar::ground
tiempos::times
progenitores::replacement
metida::leave
dictámenes::scientific
imperio::empire
consigo::brought
dedo::fingers
escrúpulos::dm
subir::top
inmensamente::immensely
noventa::mid
vakalis::vakalis
noreste::tamil
seguirlos::follow
cometido::fraudulent
cubrir::developing
desarrollado::developed
durado::maoists
salvación::saved
reduce::broadband
recientemente::recently
reproducción::duplication
prohíbe::prohibits
bromas::harder
asociado::colours
percibe::clear
allá::intend
allí::there
esculturas::sculptures
armamento::arsenal
inscribirse::names
votos::polls
ministerial::singapore
regalos::gifts
entender::understand
evp::rightly
transparencia::transparency
portavoces::mouthpieces
subió::promising
contiene::packet
promovía::subway
hablamos::dominance
limerick::limerick
reacios::confidentiality
luchas::struggles
luchar::fight
divertida::funny
luchan::fighting
pujas::preceded
desconocían::contract
seamos::us
intolerancia::destructiveness
preparativos::preparations
añicos::mari
centralizado::centralised
autopista::blaze
obama::obama
vivienda::serving
preocupante::worrying
viviendo::simpson
continuamente::hear
debajo::below
resolverse::resolved
revisar::review
altibajos::downs
definición::definition
gastando::taxpayer
segundo::second
pasan::waters
internas::reorganisation
organizada::organised
pasar::pass
arquitectura::com
supermercados::supermarket
inhalación::locked
separado::stability
organizado::organised
cuáles::admissibility
conservación::preserving
nasal::pneumonia
encantan::crazy
virus::virus
plan::plan
ordenadores::computers
sentar::individual
atolladero::escaped
existiendo::prevail
quizá::perhaps
galway::illness
estadísticos::plug
planteadas::ill
fiscalidad::primarily
posponer::suspend
microsoft::microsoft
publicidad::advertising
reglamento::rules
session::session
abrir::blaze
defender::motors
crece::wonders
coreanos::korean
grecia::greece
emergencia::emergency
algún::truth
erróneo::name
secular::secular
finalidad::drift
embajadora::posted
cresson::cresson
especie::kind
superiores::graduates
animará::migrant
parmalat::parmalat
necesitan::need
situadas::spare
voluntariamente::confidentiality
recta::straight
egipto::egypt
fusionado::eventually
ser::be
agonizan::hopes
silla::wheelchair
kilo::eurocents
entusiasmado::himself
sea::hope
activista::encountered
taiwán::taiwan
censurado::censured
mordejai::vanunu
calentamiento::warming
esclarecer::britons
guinea::guinea
reunieron::speech
superpuesta::palace
dominar::masters
departamentos::departments
merecen::deserve
pagar::pay
europa::europe
discursos::hidden
amnistía::inhuman
piedras::glasshouses
pagan::organic
reaccionó::reacted
sadam::hussein
gustado::tackles
pdn::npd
oriente::east
controvertido::controversial
celebra::friday
celebre::summit
imaginar::imagine
celebro::salute
pensamiento::conclusions
corresponde::centres
provengo::destroying
fanático::multinationals
conjunto::whole
acabó::cold
calcula::lone
conjunta::points
reciba::commands
recibe::fisheries
representativa::rests
recurrir::unlicensed
levantarnos::blatant
democratización::immune
ejecutivo::appointment
duras::tough
durar::radioactivity
ocasionados::elderly
impedir::prevent
brotes::illness
dominio::dominance
error::mistake
microbios::microbes
admiro::admire
soporta::permit
medicamentos::medicines
sindicales::shipyard
motors::motors
mismos::ourselves
obligatoriedad::binding
rusia::russia
celebró::spirit
triple::oh
voy::shall
voz::voice
excesivo::accident
acabe::traps
acaba::factory
deteriore::swiftly
fomente::encouraging
excesiva::stigmatisation
salarial::indication
derretimiento::snowfalls
clubes::talented
safiya::safiya
contestar::afterwards
caer::dusk
necesitará::japanese
recibí::spare
expresarme::fabre
año::year
euro::euro
materna::tongue
recorrer::go
navegación::shipping
suscitado::impressive
conversar::calderón
concreta::expressed
descubiertos::screening
obligados::forced
lograrlo::achieve
concreto::concrete
bancos::banks
lujo::luxury
aunaron::madeira
combinan::competence
salvo::stalinism
sagrada::sacred
palestinos::palestinians
distanciamiento::drift
arresto::arrest
prevención::recurrence
habrían::indicated
fría::cold
castigo::siege
frío::cold
acusaciones::accusations
puesto::resign
organizadores::campaigners
creía::proud
acerca::raised
puesta::raised
tomar::decisions
formar::everyday
envenenar::poison
australia::australia
antiguos::adversaries
inanición::starvation
hayan::remarkably
demanda::demand
forman::books
formal::formalized
globalizado::globalised
d::user
guste::comply
esclavitud::slavery
continua::continual
faceta::struggles
continuo::smuggling
subvenciones::subsidies
iniciará::multiannual
oval::shenanigans
dinamarca::denmark
legales::legal
señalización::rolling
comparan::lorries
seudorreforma::gangster
papiloma::papilloma
decisiones::decisions
elaborados::processing
exportaciones::exports
templo::debauchery
comparar::comparisons
nómina::slip
presidente::president
dolorosa::synthesis
aplausos::applause
caros::expensive
denominación::name
cauce::expected
reacciones::reactions
llamar::draw
santa::holy
emocional::controversy
pareja::replacement
comunes::shared
juvenil::youth
veces::sometimes
parcial::employment
regionalización::regionally
paraíso::unspoilt
aumentaría::placed
anterior::previous
procesos::biochemical
clinton::shenanigans
teniendo::casamanca
integral::embracing
soportar::competing
integrar::integrated
percibida::perceived
pierde::lose
separatismo::separatism
gases::gases
prensa::press
consideramos::consider
anaquel::stand
alcanzaron::circulatory
personalidad::vip
votar::vote
quién::who
realista::realistic
temores::fears
indigentes::destitute
urnas::turned
laborales::prevail
considerable::considerable
ministerio::ministry
cia::cia
inhumano::inhumane
cig::organizations
uu::m
indican::surveys
tasas::rates
un::a
indicar::mighty
escrita::written
escrito::written
formulado::aspe
paciente::patient
chad::chad
estilo::harmonisation
obligatoria::compulsory
diverso::diverse
obligatorio::consultation
montón::lot
bélgica::belgium
españa::spain
preguntas::questions
preguntar::swiftly
explicárselo::explain
carrera::career
hepática::actual
temor::ignorance
transmisión::transmitted
exenciones::identical
secundaria::cesr
obliga::continually
semejantes::insignificant
relacionadas::spectrum
negociadora::chapters
longitud::length
elemento::element
miles::thousands
satisfaciendo::satisfying
resistencias::permit
mismas::corrective
carreras::bet
detiene::detained
verdes::green
teléfonos::mobile
válidas::hallmarks
ataque::ashkelon
delincuente::beside
regiones::regions
maastricht::maastricht
incumplió::missed
numerosas::preceded
resulte::becomes
satisfacción::audit
resulta::find
seno::heard
impresión::looked
young::ernst
reemplazo::replacement
alemanes::unionists
contribución::admire
firmó::signed
sometida::totalitarian
tortura::tortured
sometido::superfluous
idéntico::peijs
llame::racist
llama::burn
nieto::grandson
bonitas::fine
shetland::grew
insuficientes::prescribed
magia::trick
opiniones::opinions
apretón::shake
desenvuelta::lorry
pueblos::assert
tomemos::drugs
ulster::ulster
ecológico::nature
železný::reprimanded
ecológica::surrounding
resultó::fiasco
noticias::news
privilegio::privilege
crezca::grow
fortuyn::fortuyn
descuidar::neglect
fascistas::stalinism
biomasa::biomass
sentencia::ruling
directiva::directive
disponible::available
obstante::anticipated
incendios::fires
firma::signing
ukip::ukip
firme::stronger
escándalo::scandal
turismo::dark
enterrado::buried
budiaf::conversation
autorización::authorisation
difícil::difficult
tragedia::tragedy
monedas::coins
caza::hans
lee::reads
chinas::destroy
colaborar::cooperate
niveles::levels
les::them
envié::athens
prefiere::nauseam
ley::law
desencadenó::sparked
baronesa::baroness
símbolo::symbol
residente::symeou
titanic::titanic
oficial::lookout
delors::delors
rda::gdr
causas::causes
consejo::council
londres::london
palabra::word
complacer::portfolios
abusivas::abusive
verlo::anybody
incorporarse::newcomer
opinó::opinion
cualquiera::anyone
milagrosa::miracle
vuestra::tardiness
período::period
cliente::logged
sabe::knows
constancia::troubles
loco::madman
lema::motto
proceso::process
sociedad::society
flamenco::flemish
falleció::mother
suceso::intend
birmanos::burmese
animar::encourage
alejado::surprised
proseguir::libya
estratégica::realities
animal::born
opina::statements
estratégico::encouraging
pretexto::se
cristal::glasshouses
especial::special
singular::peculiar
húngaros::myself
partidos::parties
reinan::prevailing
hawk::hawk
centrar::green
póker::poker
cambiará::change
teoría::theory
boeing::boeing
aliados::allies
dafne::daphne
asciende::figure
robot::robot
repercusión::amr
méxico::mexico
comerciantes::tradespeople
bordo::aboard
pidieron::leisure
borde::threshold
directa::direct
interlocutor::partner
directo::direct
operativo::operational
producen::abused
nació::grew
mejores::better
expresaron::goal
ejércitos::armies
etílico::ethyl
competidoras::comprehensive
fortaleza::fortress
cambiarlo::change
puerto::dover
aceptar::accept
opino::think
nada::nothing
perjudicial::bad
realiza::carrying
cosechado::excluding
policial::custody
tantas::chairmen
empleado::illegally
complementando::negligence
confinado::horrible
obtenido::stations
constitucional::constitutional
cuándo::reply
educación::education
claridad::clear
energética::energy
garantizamos::earnings
agricultura::agriculture
occidentales::satisfying
motivos::reasons
ejercicio::strike
acordado::maoists
superioridad::superiority
carencia::correct
jeenbekov::kyrgyz
cesr::cesr
paquetes::packages
remunerados::correctly
ordenador::pupil
realizó::completed
precarias::constituents
comprometidos::illicit
freno::curb
cuidado::junior
david::david
medidas::measures
postdam::snowfalls
potencias::powers
ihh::counter
festival::kids
legislativo::implemented
cerca::car
dependía::depended
armonioso::conducive
armoniosa::helping
decirlo::lookout
diagnósticos::verdicts
ratoncito::produced
lentitud::slow
lugares::places
persecución::persecution
endeudamiento::borrowing
elite::mostly
asistido::struggles
mediodía::minutes
bergama::allianoi
dejemos::playing
comunidades::communities
fármacos::cosmetics
sugerimos::delors
falsa::misrepresent
ciudadana::newborn
ciudadano::citizen
falso::trick
ayudarán::constructive
volveré::back
vaca::cow
tensiones::dilemma
dijeron::newspapers
afirmaron::lawyers
umbral::hiv
tobback::related
cuatro::four
desventajas::disadvantages
latina::america
documento::document
empleo::employment
manos::hands
emplea::surface
ucraniana::ukrainian
financieramente::financially
escuchado::sometimes
sueca::prohibits
avance::breakthrough
repite::nauseam
repito::repeat
aprendan::learn
producirse::starting
pruebas::testing
última::last
europeos::europeans
calificado::stupid
agencia::agency
manchester::manchester
relativas::entrepreneurship
revés::reverse
veremos::happens
principal::main
permanecemos::helpless
terminar::rebates
destinó::liquidity
terminal::terminal
zapatos::boots
plantea::poses
manifestaciones::protests
familias::families
familiar::embracing
patrocinio::formula
generales::integrating
autor::resale
elegidos::elected
h::probe
aea::saa
determinante::brain
vayan::ease
dejado::longer
transfronteriza::ahead
perdido::lost
transfronterizo::deliberate
operativa::revised
paseo::walk
cristianos::christians
nuclear::nuclear
parque::mount
inestables::tools
azar::coincidences
rheinmetall::firms
destino::destination
confirmar::cyclical
planteé::fake
masiva::destruction
cristiana::christian
también::also
ende::protein
nieve::snowfalls
abusos::abused
privados::segment
exactitud::taxpayer
cerrados::closed
barras::bull
abstenido::abstained
liquidez::liquidity
redundancia::superfluous
co::co
cm::cm
recurrente::recurring
órganos::donation
ce::ce
escudo::fretting
señor::mr
cs::cs
sentirme::board
productividad::absenteeism
abiertamente::openly
estén::countryside
miembro::member
decidido::resign
equipo::team
opciones::plenty
dirigentes::constant
puerta::door
mostró::prepared
considerablemente::dollar
intenta::reignite
dosificación::laundry
fondos::funds
automático::dispensers
dañada::warmer
va::going
ve::sees
vi::berlin
democráticos::values
fraudulento::intellectually
plataformas::underworld
dañado::disservice
serlo::bus
indicó::indicated
tarjeta::spare
degenerada::perverted
una::a
juan::paul
someterse::rigorous
destrucción::disposed
económico::economic
laschet::laschet
färm::rightly
víctima::victim
económica::economic
franja::fatah
sadc::sadc
venciendo::defeating
reparado::repaired
competir::compete
continuidad::initial
supuesto::course
bala::silver
padres::parents
ataúd::coffin
indonesia::indonesia
contribuyentes::taxpayers
advertencia::serve
generalizada::widespread
momento::moment
complicada::synthesis
tansu::tansu
complicado::replied
generalizado::immune
excluidos::compulsion
escritores::conjuring
alimentaria::food
aeroespacial::aerospace
alimentario::th
mantienen::hushed
espalda::turning
nacional::national
mantienes::stay
proposiciones::concepts
diyarbakir::iranian
doce::twelve
constantemente::directing
salario::lower
incomprensible::incomprehensible
interceptados::plates
conservador::eurosceptic
symeou::symeou
finalizado::core
periodos::periods
cruz::cross
zimbabwe::starving
limpiando::volunteers
durante::during
pies::feet
evitarse::avoided
cosas::things
orfanatos::unquestionably
quitarle::transferring
reguladores::cesr
suspendido::resumed
presentar::presented
muro::wall
conservar::telephone
cabría::lifting
necesidad::need
difiere::destroy
mozambique::mozambique
clientes::inform
interviene::intervening
presentan::problems
recordamos::apparently
introducimos::stricter
sábado::saturday
pequeñas::small
obtuve::obtained
pintura::mattel
obtuvo::successful
sabremos::clearer
desgracia::unfortunately
señalarlo::keen
calificación::manipulation
iris::cable
compromisos::binding
economía::economy
cadena::chain
volvieron::ortega
ciudadanía::affirmed
tratamientos::specialised
software::garage
activos::valuable
objeciones::concerns
obtener::obtain
luna::installation
donde::where
voluntad::libya
exterminio::camps
banco::bank
proporcional::founding
sujetas::regulations
alaba::rationale
muerta::star
muerte::death
celebraremos::pl
demostrado::shown
condenado::convicted
asesinado::royal
grato::generosity
condenada::stoning
despegue::stone
protestamos::elimination
placer::rico
fuad::ahmed
meta::working
circunstancia::circumstances
estricta::stringent
especiales::special
colega::colleague
estricto::narrower
disfrutar::mari
olvidados::unused
economías::economies
dichas::spoke
sharia::sharia
avanzado::grown
religiosas::minorities
avanzada::older
frecuencia::often
imaginarios::conjuring
apoplejía::pneumonia
consensuadas::surprising
sostenible::regulating
externos::integrated
recibido::received
prometer::soldiers
demasiados::burdens
pronunciada::ibrahim
polonia::poland
consideración::twelve
misión::honourable
rural::rural
humanidad::humanity
seguía::attached
augurio::augurs
decepción::enthusiasts
polacos::poles
ucrania::ukraine
transitorias::vague
colegas::colleagues
suicidas::bombers
solteras::lone
retirar::warmer
expuestos::campaigners
profundización::deepening
caducidad::sell
inundaciones::orleans
afirmar::tasks
temíamos::tbilisi
integrada::advocates
optimista::optimistic
muertes::deaths
solidaridad::solidarity
policías::target
infectada::infected
incorporar::incorporate
mencionar::mention
lectura::obtained
hora::summer
presidio::translated
cuentas::accounts
cuentan::delegates
consignas::slogans
huele::petroleum
docenas::dozens
negligencia::malpractice
recaer::hardest
ayman::falsifying
calendario::for
desigualdad::jurisdiction
tendrán::undemocratic
incrementado::increased
interna::internal
revela::kla
darles::responding
balance::assessment
futuras::future
japón::accident
ahorro::hotly
olímpicos::olympic
viejo::understandable
total::total
disculpa::tardiness
estancia::kuhne
explotación::exploitation
negativa::harm
alemanas::firms
nombró::instructions
ideológico::idealistic
amenazando::nationals
solventes::borrow
malestar::youth
continuar::continue
creencias::beliefs
holocausto::holocaust
pudo::could
explotan::bombs
reticente::reticent
servidores::humble
restos::traces
tolerar::populism
permite::allows
permita::initial
beneficios::profits
internacionalización::casamanca
empieza::begins
intervención::speech
necesitábamos::curb
difundió::newspaper
trasladan::goes
india::india
invertido::modernisation
esfuerzos::efforts
trasladar::deliberately
prisión::prison
comercial::breach
cinematográfico::film
objeto::watched
significar::mean
nombre::name
físicamente::liquidated
hong::hong
atraer::flock
olimpia::agonising
fijamos::insurer
las::the
orden::order
padre::father
diferencias::differences
hasta::until
liberales::wonderful
cuidados::care
lazos::divide
teatro::unequivocally
elevar::contributes
modesto::modest
próximos::next
japan::respectively
mayor::greater
aprobar::sixth
fábricas::employ
venta::sale
eleva::risen
ilegal::illegal
valor::nature
comprobar::observed
elegido::elected
estimadas::dominican
arqueología::archaeological
designada::posted
prisioneros::held
autorizados::unlicensed
safa::safa
billetes::notes
bang::bang
repercutirá::sellers
ajustes::revealed
bank::rationale
regule::noise
regresé::mixed
regula::clarification
pasillos::corridors
pobre::poor
prácticas::practices
vinos::wines
mostrarnos::punishments
promover::promote
european::european
vidas::saved
procurar::gets
estabilidad::stabilisation
crimen::organised
logo::logo
hogar::cities
seguimos::trying
presidenciales::presidential
carteles::unloved
imperialista::imperialist
cría::rearing
términos::terms
vaguedades::lax
afectarán::acting
medicina::medicine
marca::ce
veto::veto
culminación::completion
propone::proposes
ambientales::taxes
aparición::shaken
productos::products
pasaron::volunteers
realizar::mountainous
elecciones::elections
regreso::return
afirmado::maputo
políticos::political
regresa::expelled
estadounidenses::americans
dispersas::pieces
comercios::eurocents
podemos::cannot
realizan::improvements
incubación::incubation
representación::founding
organiza::runs
mantequilla::shortbread
hagamos::facts
pésimo::rotten
pernocte::specialised
grifo::dried
establece::tough
playa::seaside
equilibrio::balance
aire::air
ocurrió::liquidated
responsable::responsible
resolución::resolution
inadvertido::gesture
evidentemente::obviously
john::john
próstata::prostate
enfrenta::faces
compromiso::compromise
comprender::understand
solvit::solvit
ingente::deserves
oír::britons
avanza::slow
receta::miracle
recurriendo::superiority
primavera::spring
propagar::spread
intelectualmente::intellectually
continúan::wailing
civilizada::civilized
hemos::we
cosida::sewn
completará::manipulation
galardonado::heartily
evolucionado::evolved
organizó::azores
tomamos::original
salvar::saving
galardonada::aung
diabético::diabetic
comunicaciones::communications
primaria::primary
anoche::renault
ocurrir::phenomenon
inquietudes::chairmen
síntomas::symptoms
inmediatamente::immediately
negado::denied
atmosférica::pollution
interesado::chapter
podía::rapporteur
reconocía::kuwait
grave::serious
armonización::harmonisation
aung::aung
hacen::turns
responder::p
bebé::baby
latinoamericanos::latin
producir::deliveries
responden::scoreboard
televisiva::broadcasting
reserva::reserve
protestando::protesting
pieles::doubtful
kirguís::kyrgyz
realizada::ernst
madeira::madeira
subvencionados::receive
emprender::action
realizado::tried
debemos::we
función::service
solicitantes::refuge
marinho::marinho
declarada::malpractice
permanentemente::informed
declarado::offence
rincones::protests
atreve::downwards
di::woke
atrevo::unlawful
dc::holocaust
da::inspires
joven::young
dr::ibrahim
concluido::chapters
anulación::notifying
sentido::sense
depende::depends
cancelar::waldner
observen::tradespeople
guantes::wrap
eres::unfair
publicación::shorten
partiendo::timing
permitan::workplace
bien::well
materiales::materials
viernes::friday
georgianos::georgian
dé::certainty
ratificó::clients
sesenta::sixty
elaborado::auspices
vías::avenue
convertible::manchester
ámbitos::preparations
visión::vision
subterránea::dirty
tardado::remarkably
muhammed::ahmed
nominales::nominal
operador::telephone
estuviera::watching
ahora::now
mercosur::downs
conclusión::conclusion
cotizaciones::contributions
común::common
con::with
habían::had
mercurio::excess
candidato::david
identidad::identity
edición::cable
tony::blair
plantas::protein
convirtió::became
porcentajes::error
verduras::distribute
flexible::wording
pasaba::kenya
últimamente::stoning
equivale::equivalent
marítimo::complied
marítima::maritime
libres::free
posteriores::wounds
textos::texts
despiece::cutting
air::flight
charleroi::stadium
euroescéptico::eurosceptic
características::feature
homicidio::symeou
funcionará::nauseam
pensión::mdl
excelente::excellent
añadírselo::discolour
vinculación::enable
tardanza::tardiness
sterckx::sterckx
preciosos::rhodium
trasera::spare
grandioso::preparations
pflüger::pflüger
anual::annual
ocasiones::occasions
conscientes::views
platino::rhodium
incremento::discussed
tíbet::tibet
creamos::prodi
hans::hans
darle::refuse
darla::floor
seguimiento::follow
ganarse::winning
recurso::resource
campo::adds
causando::grybauskaithas
decisión::decision
supervisar::rostrum
the::the
fisionable::occurrence
juegos::games
punible::offence
operación::operation
petersburgo::petersburg
fundamentalismo::fundamentalism
disposiciones::necessitate
provisto::maputo
divorciarse::babies
grybauskaitė::grybauskaithas
cuales::subjects
mayo::may
películas::films
preguntamos::well
quedé::amazed
específica::effectively
aranceles::taxes
capa::ice
croatas::croatia
cruzados::crusaders
jornada::wording
obstinación::federalist
preparados::prepared
adoptó::evening
ustedes::you
multilateralismo::pursue
sumamente::extremely
salir::resolve
taher::ahmed
comienzos::repeated
resto::rest
josé::josé
juez::judge
sufrirán::ill
cumplimiento::christmas
extravagancia::extravagance
existente::casamanca
seminario::seminar
estimados::dominican
familiares::relatives
queda::go
fenómeno::phenomenon
deberán::gardens
concentraremos::reinforcement
pozos::wells
selva::unspoilt
tendencias::trends
buscadores::equivalent
esperamos::hope
vladimír::reprimanded
pintadas::sötét
reglamentos::supervisory
opio::poppy
mortadela::ham
jacques::delors
instalación::installation
infraestructuras::primarily
propagación::spreads
lamentablemente::unfortunately
afecta::affects
dispuestos::grant
llevó::shut
formidable::web
pantalla::screen
litigios::disputes
rápido::faster
recuperemos::gain
dictador::dictator
naciones::nations
influirá::employment
suyos::gesture
llegamos::came
inmigrantes::migrants
esposa::markovic
reanude::resume
mortalidad::mortality
ceder::chairmen
robar::steal
celebramos::foundations
subrayado::stressed
análisis::analysis
hambrientos::acquisition
pérdidas::colossal
perdemos::lose
fueran::caught
siquiera::sky
anfitrión::host
fazakas::fazakas
lleve::stalinism
lleva::where
detenido::arrested
queríamos::wanted
cuya::amr
récord::record
ayuden::spread
sorpresas::surprises
cuyo::czechs
oímos::lowered
históricos::destroy
controversia::socialism
gdańsk::gdańsk
vulnerables::vulnerable
escala::scale
cesión::transfer
responsables::responsible
esposas::wives
armonía::claims
aceptarla::force
reduzca::radical
intercambios::imposing
aceptarlo::accepting
espesor::centimetres
celebración::essen
global::warming
aprovechado::suspend
hocicos::pigs
zona::zone
elevada::catches
impulso::push
elevado::absolute
extremadamente::extremely
quienes::those
finlandia::finland
aclara::accurately
campiña::wind
aclare::clarification
humo::smoke
importante::important
terror::terror
educar::educate
cómo::how
circulación::movement
creciendo::markedly
hospitalarios::specialised
oponernos::strongly
entretanto::begun
comunitario::eventually
comunitaria::preference
confiemos::parent
necesidades::constitute
funcionar::function
presentes::present
libanesa::lebanese
indicaban::surplus
jugarse::fourthly
frontex::frontex
modernizarse::modernise
rusas::russian
funcionan::work
decenio::decade
participan::involved
cosa::thing
cubre::predictable
aumenta::increased
repente::suddenly
revista::magazine
participar::participating
razón::right
curso::graduate
engaño::dressing
demográfico::mysterious
quedan::wife
carga::burden
quedar::basic
ocupaba::visible
desinterés::desirable
aburrimiento::boredom
arrestados::constant
estatus::status
enfermos::prohibiting
andina::andean
dediquen::meaningful
acción::action
revisaré::fabre
montreal::montreal
cien::satisfied
bruselas::brussels
italiano::italian
maputo::maputo
metros::metres
chicos::buried
bloques::centimetres
organizarse::organized
continúa::continues
mitad::half
francesa::french
bloquee::blocked
diálogo::dialogue
vanguardia::garde
club::club
restablecer::restore
contienen::rhodium
anuncio::announcement
malparados::pioneers
remonta::stretching
incidente::unequivocally
tácticas::holdings
iba::thought
inflación::inflation
seguros::doubts
estupendo::splendid
can::we
cabeza::memory
distribuidor::mattel
reírse::laughing
recambio::spare
perder::dimension
margen::margin
gastos::expenditure
reducidos::halved
regalo::finer
movilización::widely
carrefour::carrefour
productiva::saving
criterios::criteria
trayectos::improvements
edificio::building
sacudido::shaken
desarmarse::disarm
años::years
fútbol::football
rechazo::repudiate
otorgamiento::fair
adoptado::acting
anunció::installation
daneses::danes
rechaza::decline
produce::exception
estaría::perspective
kazajstán::kazakhstan
ambición::ambitious
turbulentas::waters
vaya::alarmed
pidió::condom
columpio::thither
recibió::received
hacia::towards
orgullo::proud
diámetro::constituency
cola::licensed
forma::way
suprimiese::invasion
emigrante::emigrant
formo::honourable
necesitemos::logical
debía::leave
frecuente::prevalent
tje::disservice
protegido::constitutionally
not::what
francos::frf
nos::us
implicado::grybauskaithas
derogar::lifted
james::nicholson
cuenten::requisite
intimidados::liquidated
mundialización::recurring
desde::since
racimo::accidents
citar::liberal
el::the
en::in
ee::m
cairo::cairo
actuación::require
recibir::inspection
injustas::unjust
restricciones::ease
amsterdam::bang
sorprendidos::surprised
es::is
flujo::drying
documentación::hypothetical
expulsión::expulsion
querrían::yellow
otorgado::orientates
añaden::amendments
criminalidad::criminality
asistir::attend
cars::cars
segundos::somebody
contábamos::before
iban::traders
caro::derivatives
gravedad::severity
cara::hidden
ubicación::location
plomo::mattel
luego::further
profesa::federalist
british::respectively
unidades::units
resultados::results
comprensibles::understandable
aterrizaje::mountainous
observamos::irregularities
impidió::prevented
verdaderamente::convincing
llegar::migratory
anticuada::kalanke
riesgo::risk
éstos::lie
llegan::lax
elementos::elements
justicia::justice
implicaciones::implications
preparada::solutions
agrícolas::agricultural
desequilibrio::imbalance
sobrevivir::illegally
pelea::believed
transcurre::crow
bajo::under
baja::lowest
inteligentes::mayors
quisquilloso::troublemaker
conciernen::solvit
católica::catholic
olvidemos::forget
estudio::study
favorablemente::involvement
empeño::throwing
vitaminas::vitamins
estudie::scrutinise
enteramente::governments
cáucaso::caucasia
burocracia::splendid
manifestaron::demonstrators
biodiversidad::lagging
septiembre::september
estructurales::structural
equitativo::founding
vivamente::engage
decisivos::concepts
antecedentes::unblemished
entrarán::competence
catástrofes::disasters
identificar::intellectually
alguno::safe
efectuar::verb
declive::broke
convencido::believer
dirección::direction
seguir::continue
conformidad::compliance
institutos::names
denominados::integrated
actualidad::prefabricated
levantamiento::upheaval
german::marshall
infecciones::infections
salarios::nominal
continuada::expanded
enterado::rotterdam
adolf::adolf
israelí::israeli
masivo::creaking
energía::energy
internacional::international
tienden::frequency
acelerar::speed
conducirá::barriers
buttiglione::buttiglione
emigración::rocketing
geopolíticas::realities
guantánamo::guantánamo
jiamusi::jiamusi
vienen::secondly
unidos::united
señorías::gentlemen
compartimos::standpoint
leus::mdl
sonar::grand
descentralización::decentralization
alimentación::indigenous
bulgaria::bulgaria
miseria::misery
convertido::become
véanse::reactions
sinónimo::synonymous
acontecimientos::events
contar::banks
culpable::guilty
requerida::successful
reducción::reduction
aeropuerto::airport
estar::be
estas::these
emanan::authenticity
sufrido::inhuman
suicidio::suicide
amplio::scope
amplia::wider
misterioso::mysterious
convertirse::another
documentos::documents
ambiente::environment
esterlinas::plant
seguido::trailing
comen::excess
ciertos::certain
suministrar::straits
seguida::hit
finales::late
comer::feed
habituales::snowfalls
simplemente::simply
ambiental::hear
distancia::distance
prometido::promised
cuando::when
monumentos::residential
amina::amina
afectado::linked
atenas::athens
insurrección::compatriots
eads::firms
siete::seven
contrario::contrary
característica::feature
sudán::sudan
acogió::took
informes::reports
repetido::keep
denunciar::denounce
denuncias::accusing
intercambio::exchanging
crecimiento::growth
milenio::commences
convencionales::seekers
colegios::closed
moderno::modern
desnudas::volunteers
iniciada::derogation
incluye::testimonials
iniciado::inquiry
negras::blackest
buen::business
transitorios::periods
movilizó::rebel
permiten::comment
velocidad::slow
eran::were
consulta::interested
sabíamos::fusion
diseñada::sewn
utilizar::using
inmunológico::immune
medio::half
media::coach
milicias::tricks
efectiva::opens
efectivo::amass
fortaleciendo::ties
belarús::belarus
millón::reckons
negativas::negative
escasa::rels
socialistas::socialists
porciones::pieces
observarse::landmass
demonizar::demonise
transmiten::skills
garanticemos::earnings
oiea::iaea
tolerancia::lifestyles
informarles::rico
tipos::types
retirada::lifting
masacrados::massacred
inmune::immune
retirado::withdrawn
actos::commit
expresado::raised
ésta::speech
utilizada::immense
complemento::guaranteed
éste::first
euros::eur
racismo::racism
utilizado::imposing
deberá::send
verse::voter
real::real
pacíficos::followers
alzan::fingers
lado::side
relativos::plug
vasco::basque
campos::camps
librar::unfair
libras::owed
sagrado::slip
episodios::toll
espectador::el
fortune::fortune
económicas::economic
mensuales::hawk
finanzas::dogmatism
máximo::maximum
moreno::seaside
comentarios::comments
máxima::globe
estimaciones::lucrative
productores::producers
similares::packages
pronunciar::use
héroe::hero
hepatitis::hepatitis
compañeros::colleagues
llevada::sweden
controversiales::mitchell
francia::france
llevado::worst
detectores::gdr
sra::mrs
central::central
despidos::firing
ocupar::buttiglione
harían::misery
ocupan::departments
constitucionalmente::constitutionally
liderazgo::enabling
adjudicaciones::tenders
diversidad::preserving
intentó::warsaw
goethe::quoted
evidencia::caused
ganado::cattle
morir::die
ojalá::ease
protesta::protest
transformar::outer
impresionante::impressive
prepara::intends
premio::prize
barco::aboard
monstruosidad::negotiated
los::the
petróleo::oil
dispone::disposal
obligación::duty
sabemos::know
gaza::gaza
intérpretes::interpreters
jueces::selecting
sirve::fund
posterior::kalanke
sirva::serve
cumbre::summit
registró::th
telefónica::telephone
produzca::wherever
toda::whole
depresión::depression
iraquí::iraqi
propiedades::asset
siguientes::addressed
vendrá::bulk
ashkelon::ashkelon
próximas::mountainous
mueran::die
describe::innkeeper
organización::organisation
relevante::surrounded
salen::category
tengo::i
intente::emulate
milicia::smuggling
tenga::pacifist
intento::attempt
conflictivo::binding
distribución::distribution
aduaneros::solving
registra::northeast
cuerpo::service
exagero::exaggerate
proclamación::proclamation
fiscal::exemption
modificado::rapkay
cientos::hundreds
dólares::dollars
escasez::resources
operadores::segment
famoso::planned
famosa::generosity
monte::mount
tenido::procyclic
indicadores::scoreboard
inversión::lay
inteligente::intelligent
correr::jeopardized
correo::mail
llevarán::changes
ciudad::city
acusa::initiating
habla::talk
hablaremos::spoken
hable::please
interesan::prosecution
excedente::surplus
hablo::ireland
semejante::perspective
lieja::o
estando::curse
pretendimos::marinho
estaba::was
jensen::engage
comercian::tough
horror::total
despido::slip
decide::disputes
inaugurado::decade
louis::louis
menor::although
mundial::world
subsahariana::somebody
compensación::compensation
únicamente::receive
calderón::calderón
música::music
cuyos::core
hautalasr::yellow
tradicional::traditional
complica::complicates
destruyendo::destroying
juicio::resolved
concentración::concentration
unánime::nominated
ayudar::help
ayudas::aid
habló::objections
destinada::duration
destinado::mechanism
deportivos::sports
irak::iraq
crueldad::cruelty
cedió::remained
podrá::driving
verá::deliveries
pionera::fore
llamamiento::appeal
ilegalmente::unused
iraq::iraq
situaciones::insignificant
decidí::chose
arena::her
reparos::objections
suicida::suicidal
argumentan::argue
equivocado::wrong
regulares::organizations
colores::colours
equivocada::mistaken
fracasar::experiment
thatcher::thatcher
solicitud::request
locura::madness
estrés::markedly
debían::orleans
utilizó::used
compone::consists
tumba::husband
precios::prices
documental::documentary
alcaldesa::cresson
marzo::march
dios::god
finalización::completion
descargas::music
descargar::enable
únanse::peril
atendido::originates
enfoque::approach
valioso::valuable
sorprenderla::surprising
ciertas::safe
opinión::opinion
aparezco::minutes
yemen::yemen
quedaron::districts
piezas::portions
sorbona::sorbonne
veinte::twenty
quizás::perhaps
acompañada::accompanied
fuentes::se
terrazas::gardens
utiliza::nature
buzek::buzek
botas::boots
obtienen::rapidly
inmediaciones::camp
arduo::serbia
sentará::precedent
fr::fr
indígena::indigenous
soltera::unmarried
descubren::gdr
viareggio::ham
a::to
examinado::carefully
registrado::hepatitis
transatlántico::transatlantic
convencer::convince
deudas::settlement
logros::achievements
comprarlos::buy
mojado::written
recuerdos::memories
farolillo::rear
soldados::soldiers
cardiovascular::pneumonia
previa::precondition
estudios::studies
territorial::accepts
organizaron::observers
adoptar::adopt
radical::overhauling
desilusionados::alarmed
obligaciones::citizenship
fines::pursue
yo::i
ya::already
tercio::third
beneficiarse::benefit
así::so
profundas::wounds
pidiendo::asking
tratara::robot
entendido::entities
pablo::paul
asentamientos::mitchell
dimitir::resign
sitios::websites
pilotos::confidentiality
premisas::premises
todo::everything
campamento::camp
mostrado::reticent
meijer::meijer
decía::laeken
debería::should
conservadores::portfolios
desastres::examine
navidad::christmas
papeles::meant
salvaguardias::derogations
electrónicos::mails
housel::housel
eliminado::cup
laboristas::socialists
pasada::week
base::basis
pecados::germans
basa::based
pasado::past
libros::books
papeleo::tape
comisaría::flemish
terrible::enemy
suficiente::enough
american::respectively
universidad::university
persiste::tortured
esclavas::wives
propiedad::property
promedio::diagnosed
trozo::piece
afluencia::everywhere
cachemira::kashmir
pasos::steps
cifra::figure
felipe::calderón
estatuto::statute
nigeria::nigeria
efectos::transboundary
quinientos::overnight
tomaron::drafting
norma::scheme
privadas::secure
país::country
cambiando::caribbean
basan::based
conocemos::aware
violación::violation
arbitrarios::centralised
afán::convince
situado::mount
reconocer::recognise
situada::pirker
fabricante::boots
edades::involve
debilitado::disarm
poético::poetically
reconocen::lived
actúa::asia
bioética::bioethics
admitió::buried
comienzo::start
iraníes::iranian
profesionales::qualifications
licenciatura::graduate
añadir::added
reunirse::stopover
convergencia::convergence
polvorín::volcano
nuestras::our
discreción::discretion
apoyar::support
hombres::men
desigual::whenever
pnud::complete
padecen::packet
decisorios::prevalent
fraude::fraud
conversación::renault
aires::aires
devaluaciones::devaluation
apoyan::negotiate
alegaciones::bans
beneficiado::benefited
recogida::yield
procede::channels
complejos::ardenne
intervenido::spoken
subraya::desirable
atraída::board
nucleares::nuclear
imprescindible::warmer
tener::account
debido::slowly
comenzar::achieve
ejecutores::regulate
referencia::reference
precipitaciones::snowfalls
rotterdam::rotterdam
políticamente::breach
granjeros::farmers
cultivos::crops
acusado::charged
rocco::emigrant
mercancías::goods
levantadas::commemorate
coalición::fortuyn
religiosa::religious
examinar::examining
universidades::universities
convierte::becomes
examinan::beliefs
convierta::november
aparatos::unused
juega::santa
nororiental::northeast
juego::game
calefacción::heating
reconoce::admits
grandilocuente::grand
evaluaciones::assessments
corrupción::corruption
web::website
parecen::steps
comprando::madrid
genética::engineering
pregunta::question
opongo::opposed
parecer::osce
invisible::glass
líbano::lebanon
acabará::separatism
debatiendo::bee
mantendrá::retained
dopantes::screening
salga::escaped
eficazmente::reacted
autoridades::authorities
tradición::tradition
secreto::hushed
follaje::needles
protector::fretting
costará::m
jefe::head
contras::cons
medios::media
espantosa::insurgence
cotidiana::employment
ferrero::waldner
revelaciones::revelations
impide::prevents
constase::record
otan::kla
inglés::english
existencia::existence
enérgica::repudiate
frontera::border
sobrevaluada::dollar
obligadas::babies
confrontados::thwarted
descubierto::discover
escuelas::schools
ropa::laundry
emisión::prior
seguirán::gain
deseen::web
uniforme::uniform
mandos::command
piel::coat
innovación::innovation
alta::senior
lógicamente::citizenship
carbón::coal
importa::care
frecuentes::frequently
celebrará::singapore
dinámica::dynamic
docente::focuses
respetamos::strike
conectar::responding
intestinales::illness
interinstitucional::interinstitutional
brevemente::briefly
censura::censure
reunión::meeting
bebés::babies
porcentual::percentage
convincentes::justifications
rodio::rhodium
sociología::sociology
quejan::complain
bnfl::bnfl
conseguirlo::best
supervisa::presently
bienintencionadas::wellintentioned
afectadas::affected
publicitario::advertising
ocupado::sadc
detección::screening
activamente::actively
permitió::neither
impunidad::impunity
llegarán::audience
inmensidad::reaches
presentada::inadvertently
aparecía::danish
presentado::presented
calor::heat
enfermas::developing
informar::inform
partidarios::supporters
neumonía::pneumonia
tendrá::meant
trigo::traced
finaliza::compostela
marco::framework
mujer::wife
transmitido::conveyed
triste::sad
transmitió::iranian
medioambientales::environmental
gama::predictable
llenos::lax
derecho::right
religión::religion
bolsa::sweets
convertir::slip
limitado::resource
popular::muslims
inmunidad::ferrets
eeb::bse
doctorado::physiotherapists
parada::stopover
pierre::pierre
parado::unemployed
verían::improvements
permitir::afford
exilio::victor
gracia::grace
estudiar::send
territorios::territories
gratuita::earnings
queridos::ones
sarajevo::sarajevo
gravemente::cappato
actuaciones::visible
finalizó::pvc
insuficiente::inadequate
transmitir::message
estadística::ecb
rup::ors
flandes::flanders
marcó::espoused
fisioterapeutas::physiotherapists
islámico::stoning
consciente::appreciate
prevenir::regulate
cursado::graduates
absurdo::absurd
trato::treatment
islamización::tansu
vanunu::vanunu
trata::is
agradecer::thanking
trate::floor
cambiarse::driving
leyendo::read
france::notifying
explotaciones::farms
bangladesh::bangladesh
pocos::few
repartidos::ors
medioambiental::environmental
procedimientos::procedures
prisiones::terrorists
áreas::areas
aumentarla::aiming
preparatoria::preparatory
brazos::haiti
comisión::commission
limpio::playing
limpia::irrigation
encarecidamente::commands
ordenación::accepts
reparto::apportionment
comporta::northeast
conservan::globally
similar::similar
necesito::help
necesita::interpretation
proteger::protect
adulta::dearest
adulto::adolescent
alboroto::mighty
equivocadas::percent
menosprecia::contempt
recordar::remember
toneladas::tonnes
justamente::precisely
pretenden::shorten
comprendido::rebels
comprendida::daphne
idoneidad::buttiglione
aceptación::recommend
visite::west
visita::visit
feder::erdf
pescado::fish
e::and
preferido::achieved
urgente::urgent
empezaremos::robot
nietos::grandchildren
ecológicos::organic
intimidad::cappato
mentira::dressing
sobrepasar::bypass
materializarse::conjuring
evidente::obvious
ganadores::losers
apoyado::supported
confiamos::ultimately
morel::pierre
apoyada::favour
cabezas::sheep
chinos::chinese
enormemente::niger
nuestros::our
retirarse::mitchell
lamento::sorry
peces::fish
supone::threat
felicite::speech
suecas::reserved
farmacéuticas::pharmaceutical
estiman::epidemics
suficientemente::enough
incrementándose::accident
numerosos::flock
afganos::australia
carece::empire
rutinaria::recommended
estimar::conserving
mueren::die
erradicarlo::altogether
biocombustibles::miracle
perdiendo::losing
asistencia::care
ofensiva::rebel
necesarias::defined
sólo::only
valer::enforcing
diallo::djibril
suponer::saved
preservativos::condom
admonitoriamente::fingers
estratégicas::se
reduzcan::asking
contestado::replied
defectos::errors
aprendizaje::lifelong
heredero::ukip
plenaria::aback
producto::product
vacas::boring
agricultores::farmers
electrónica::electronic
claro::clear
clara::clear
maniobra::manoeuvre
plaguicidas::plug
austria::austria
vehículo::forcing
barrios::dusk
pudiera::impinge
oponen::musharraf
exhaustivo::thorough
alrededor::around
despacho::walked
necesitaba::blackmail
coordinación::coordination
armados::compatriots
hipócrita::hypocritical
voces::fingers
pasteurizada::parmalat
vuelta::record
vuelto::frequent
formado::formed
saciedad::nauseam
proponía::ethyl
salas::cutting
espíritu::spirit
importado::uranium
importada::fraudulently
panshir::panshir
tampoco::either
control::control
kenny::arson
acertado::discussed
perplejo::oswiecim
acertada::civilians
sensación::feeling
vocabulario::pflüger
querido::dictated
residencia::shape
bastante::quite
africano::differ
añade::chad
rodeado::surrounded
otorgan::imposing
retrasarlo::delaying
ronald::ronald
victorioso::de
disponer::technology
agenda::agenda
presidentes::chairmen
aquel::pacifist
matrículas::plates
reacción::reaction
respetarse::aboard
malasia::malaysia
madre::mother
aprobaba::became
exclusivamente::merely
décadas::decades
bosques::forests
extendido::widespread
consenso::consensus
envenenados::wells
falsificados::via
lanzarnos::retreated
nokia::boots
camino::road
jurídicas::legal
decenas::tens
desastre::disaster
introduciendo::dozen
informal::rotterdam
validez::validity
moda::coups
boicoteada::boycotted
modo::way
globo::globe
paquete::packet
habría::have
satisfechos::satisfied
serbia::serbia
democracia::democracy
suazilandia::nurses
recomendable::cultures
dejaron::wounds
sudáfrica::africa
ambiciones::personalities
protegían::gases
causa::cause
irlanda::ireland
tercera::third
marea::florida
abuela::grandmother
simboliza::symbolises
amargura::conviction
masacre::armies
ámbito::prosecution
resumen::short
florida::florida
times::chosen
comportamiento::destructiveness
convierten::verbal
tabú::taboo
abandonados::ruins
christoph::bundesnachrichtendienst
suya::destroy
financiación::funding
único::only
única::only
financieros::financial
hombro::shoulders
legislativas::legislative
crearon::laid
apasionado::el
final::final
transcurrido::hindsight
muerto::eating
inocuo::cages
transacción::inadvertently
salmón::norwegian
lista::list
cohetes::fund
enviada::inadvertently
convenciendo::participation
prudentes::exiting
chipre::cyprus
pvc::pvc
formados::educated
pidiéndoles::chairmen
inválidas::naturally
cultura::culture
ficticias::conjuring
duma::duma
arbitrariamente::constant
independientes::independent
sk::sociology
tribunales::courts
prüm::prüm
trabajando::working
peligro::danger
doloroso::serbia
diplomacia::diplomacy
concedidas::fewer
posibilidad::option
arcas::npd
pensando::dozen
explicar::explain
dificulta::planning
económicos::economic
probable::likely
cima::top
controlan::monitored
laurent::rebel
días::days
malos::daphne
atlántico::atlantic
alteración::breakdown
se::the
comité::committee
minuciosamente::scrutinise
quería::record
olvidaré::husband
verbos::verb
manifestarnos::arena
prohibición::prohibition
derribado::shed
danés::danish
miliar::gunpoint
hundirse::deliveries
tiro::stone
equivalente::siege
pongámonos::broadly
bases::foundations
anárquica::creates
ayer::yesterday
libro::book
seis::six
oposición::opposition
ascender::reserved
wresinski::joseph
joint::ventures
yendo::bet
centros::centres
puestos::jobs
jóvenes::young
experimento::experiment
centrales::banks
aquí::here
protegen::sun
golfo::degrees
mediterráneo::mediterranean
directrices::guidelines
disponemos::advanced
gran::great
mediterránea::mediterranean
profesional::professional
encarcelamiento::suspend
luxemburgo::luxembourg
albania::financially
vicepresidente::delegation
vicepresidenta::promoting
interés::interest
humano::human
yugoslavia::yugoslavia
humana::controversy
desbancar::idealistic
antidemocráticos::undemocratic
arrojan::polls
luz::light
desaparición::cruelty
llamada::southwest
caja::cash
arrojar::glasshouses
octubre::october
comparable::customer
recortes::cuts
frente::face
porqué::cable
modernización::modernisation
estándar::adequate
experiencia::experience
flota::fleet
atrevido::rightly
deriva::centimetres
solía::flock
limita::limited
prostitución::prostitution
razonable::reasonable
aplauden::applauded
hito::milestone
confiar::reliance
circunscripción::constituency
contener::fattened
habitual::chamber
jamón::viareggio
contenidos::content
conlleva::coach
cálida::warmer
omnipresentes::curse
lecciones::lessons
tiene::has
soberanos::boasting
desplegado::sceptical
diarios::improvements
desafíos::challenges
terminó::functionalist
yad::oswiecim
cena::officially
comienzan::coups
conoce::boundaries
capacidad::milestone
retrospectiva::hindsight
mencionaré::stressed
forestal::surface
menores::age
seguramente::pragmatic
quemados::wells
señal::sent
estilos::lifestyles
sacrificar::coat
dependiente::indicators
aporten::remarks
contexto::intend
goza::rely
informáticas::library
repercusiones::equally
fondo::bottom
desperté::woke
viaria::existing
operan::operating
extendieron::ideas
captura::engine
tailandia::thailand
refrigeración::heating
asesinados::killed
parto::pneumonia
cecodhas::households
legislación::legislation
demás::others
religiosos::insurgence
veterinarios::veterinary
tomado::bothered
vuelva::hearts
ayudado::dangers
confiscado::fake
vuelve::voter
representante::representative
estado::state
secreta::obtained
tomada::benchmarks
recordando::rulings
cubrirse::gardens
i::i
cirrosis::actual
ocupación::occupation
enfermeras::nurses
físico::derivatives
física::physical
cierto::some
taller::matches
través::through
admisión::admission
desarrollar::develop
sexto::sixth
comentario::comment
suecia::sweden
vida::life
fumar::smoking
uñas::tooth
atrapada::eurozone
moción::censure
definitiva::final
evitará::avoid
emplazamiento::agonising
fortalecer::belonging
desean::relatives
éxitos::successes
respondió::respond
definitivo::durable
historia::history
desear::desired
deberíamos::should
submuniciones::bombs
dispuestas::willing
dispongo::explanations
tiendas::shops
éso::triggered
innecesaria::complicates
pago::appropriations
paga::tune
desproporcional::competing
ése::message
ánimo::frame
twitter::clients
aboga::migrant
pensó::waldner
rastro::trace
límites::requests
peter::owed
producido::obviously
cumplimos::fulfilling
interconectados::solving
xenofobia::xenophobia
integrantes::fisheries
manipulación::manipulation
criticado::criticised
puedo::afraid
rehén::hostage
embarazo::pregnancy
pueda::quickly
familiarizado::fellow
puede::can
persiguiendo::persecute
usar::use
soviético::feature
pagó::finland
soviética::soviet
estábamos::grant
prosigue::thither
rodea::surrounding
bodenkamp::bundesnachrichtendienst
washington::washington
amenazadas::obligation
pistola::gunpoint
bombas::accidents
primar::welfare
químicos::surrounded
usados::category
egipcios::egyptians
vaticinado::conjuring
esperando::waiting
claras::clearer
imperial::respectively
engaños::typical
checas::blatant
gallinas::hens
expulsados::expelled
norte::north
hu::hu
diplomático::polite
diplomática::diplomatic
ha::has
vigente::unlicensed
he::i
helicóptero::hawk
incluidos::socialists
cruel::removing
datos::data
alarmistas::scare
blair::blair
etapa::apparent
universal::universal
declaraciones::statements
mejor::better
financiados::financed
faciliten::conducive
masculinos::ideally
turcas::prisons
minerales::vitamins
parecida::unloved
parecido::reminiscent
sufrir::accident
señora::madam
adversarios::adversaries
permitirse::neglect
derrota::defeat
asumen::cope
evasión::evasion
bce::reacted
ortega::ortega
deportivas::sporting
simpson::simpson
alcoholismo::psychiatric
olvidó::forgotten
consiste::accountability
reiterada::smith
añadiéndose::manipulation
gubernamental::struggling
presenta::puts
presente::dilemma
marcos::dm
aprobó::register
liberalización::liberalisation
aun::shipbuilding
abre::opens
exigir::accountability
segmento::segment
aliándose::eurosceptic
vaso::glass
futuros::shaping
válido::insurer
aislados::symptoms
disminuye::dramatically
ponía::emphasis
examen::licensed
posiblemente::absorption
sangre::blood
recuerdan::instability
dedicó::serving
cultivo::cultivation
prohibido::norway
elegir::choice
incitación::jiamusi
competentes::competent
aseguradora::insurer
silenciar::silence
céntimos::eurocents
orgullosos::proud
negó::declined
contrajo::believed
ejemplo::example
olvide::codecision
gatos::coat
samoum::ahmed
vieron::forced
cometidos::documented
docena::dozen
perjudicado::disservice
abogado::lawyer
comprimidos::fake
tratos::daphne
aspectos::established
retrasos::delays
asentamiento::preceded
altitud::produces
asia::asian
presentó::censure
sobra::familiar
fuga::brain
reiterar::commensurately
sobre::on
estuve::chad
new::chosen
guapas::logo
alcaldes::mayors
golpes::coups
eventos::reliance
avanzando::condemn
categorías::categories
convertiría::wealth
activo::active
consultadas::consulted
reflexión::reflection
mes::month
activa::active
imitadores::imitators
mitchell::mitchell
adolescente::adolescent
evitarla::borrow
dedico::campaigner
terminado::missions
resta::diagnosed
espacios::determines
evitarlo::escaping
myanmar::burma
reciente::recent
reagan::ronald
reflejo::parent
moral::morals
refleje::immediate
refleja::visible
defensor::proponent
tillack::hans
nkunda::rebel
dominicana::dominican
marido::husband
encontramos::plasticisers
química::chemicals
pacto::pact
espíritus::tunisian
exactamente::exactly
impuestos::taxes
cercano::practicable
solución::solution
orgullosa::proud
flotilla::counter
prioridad::priority
cercana::cheaply
rights::watch
alentadores::insurgence
hizo::repeat
aceptarse::accepts
heridas::seriously
plantearon::days
sensibilidad::sensitively
candidatura::osce
cartas::shoulders
deuda::cyclical
cohete::lift
decirle::wanted
viejos::persist
prefabricados::prefabricated
llevamos::exception
correos::mails
retorno::preparatory
presunto::falsifying
reclamamos::regionally
alegra::shipping
autoridad::authority
cambiado::nothing
estrategia::strategy
solares::mirrors
indudablemente::certainly
camboya::cambodia
millares::owed
madrugada::brave
atención::attention
clave::key
clavo::coffin
álbum::georgian
cerdos::pigs
afirman::lucrative
tratados::treaties
cerrar::factory
personal::personal
gente::people
debió::charged
barato::deliveries
anteriormente::before
generaciones::generations
crea::creates
cree::destroys
pérdida::loss
muros::walls
constituyente::chines
políticas::policies
proliferación::paedophilia
respectivamente::respectively
gazprom::gazprom
propósito::purpose
tomaba::whatever
crecido::grew
infectado::epidemics
hubieran::cold
directamente::directly
dictadura::dictatorship
nacidos::born
sido::been
sida::aids
tabaco::tobacco
setenta::wasted
vacuno::cattle
liga::league
muere::somebody
requerir::response
oído::heard
espiral::spiral
tales::such
creó::creation
crucial::crucial
distribuyeron::stars
mombaur::failing
manda::tune
creí::read
jubilación::retirement
juristas::places
venezuela::venezuela
hermosa::wind
foto::photograph
juzgados::prepared
entran::burmese
homenajeado::officially
denominan::refer
lanzadas::campaigns
entrar::into
deseos::fundamentally
klonowski::bundesnachrichtendienst
multinacionales::multinationals
absentismo::absenteeism
maneras::variety
democráticamente::senior
rinde::annually
rapidez::quickly
grado::needles
extraordinario::exceptional
vivido::experienced
artificialmente::bans
precipite::drifting
ironía::irony
pondremos::throwing
respetar::affirmed
electorado::electorate
mostrarán::confidentiality
salariales::retirement
pasaríamos::illustrious
historial::record
historias::scare
prolongadas::weekend
comunicación::media
sanitarios::insufficient
peso::shifted
ventaja::advantage
abril::april
segunda::second
fuese::laughing
requisito::requirement
digo::aside
esperado::cup
diga::hypocritical
debidamente::meant
aplicable::thumb
régimen::regime
mattel::mattel
contratación::contract
estrellas::stars
gahrton::renowned
conforma::derogation
conforme::conform
juguetes::mouths
sentencias::rulings
despreciable::rels
habrán::epidemics
quiso::portfolios
enseñanza::innovation
liberación::hoped
adjourned::session
quejas::complaints
ricos::rich
trabajadores::workers
nacido::newborn
sometió::malta
fiscales::prosecution
sensibles::susceptible
máquina::machine
cerebro::brain
regular::regular
uclaf::uclaf
datan::traces
alimento::equivalent
alimenta::radicalisation
inglaterra::england
generación::generation
doy::gives
comunismo::communist
dos::two
direcciones::determines
dover::dover
retire::kalanke
objetivos::aims
quieren::want
aspiración::ceiling
rebeldes::rebels
anunciar::madeira
recordatorio::extravagance
comportar::heating
principalmente::mainly
empirismo::dogmatism
exporta::pork
apoyamos::support
penalizados::sale
imprimir::print
refutación::rebuttal
votantes::voters
vemos::see
bar::bar
circunscripciones::deplore
afectados::affected
brazo::modest
complicados::complicated
momentos::moment
pocas::nothing
mantenido::surprising
creo::think
combinaciones::screening
conferencia::conference
haitianos::haiti
cuello::bottleneck
volviendo::turned
elevadas::lorries
astillero::shipyard
vinculantes::binding
marcar::turned
marcas::trademarks
artificial::landscape
marcan::mark
elaboración::engage
omc::wto
declararon::decade
complace::satisfied
ancha::broadband
diestro::divide
trabajaban::employ
progresar::hopeful
considerando::holdings
lazo::ribbon
mínima::minimum
mínimo::least
belgas::belgian
conciliación::nevertheless
argelia::algeria
une::constructive
ernst::ernst
uno::one
cenar::dinner
agitación::inevitability
cepos::traps
controlada::designation
codecisión::codecision
equivocados::contrast
espontánea::occurrence
interesa::interested
tayikistán::collapse
grupos::groups
navidades::volunteers
caballa::mackerel
asesinada::killed
delinquir::organized
construyó::existing
surja::plant
cosméticos::cosmetics
pragmático::believer
día::day
pueden::can
restante::channels
pragmática::pragmatically
conclusiones::conclusions
intensidad::frequency
alemana::german
tiroides::thyroid
policiales::buried
gracias::thank
encontrar::find
servir::receive
servicios::services
realice::investigated
cajones::unused
ir::racism
it::hotly
ii::ii
discapacitado::person
in::invaded
discapacitada::crippled
indemnización::earnings
misiles::rockets
volúmenes::emphasise
produzcan::devaluation
deforestación::deforestation
diferencia::difference
pantanos::rivers
compañías::companies
lunes::monday
ello::bad
ella::she
palacio::palace
solicitudes::applications
aparecen::copies
aparecer::sets
créditos::appropriations
hacer::done
empobrecimiento::impoverishment
huérfana::disappear
presta::giving
programa::programme
provisiones::provisions
roma::rome
abjasia::reignite
anunciadas::wonder
cambiar::change
fundamentales::fundamental
mientras::while
brillantes::illustrious
human::watch
énfasis::emphasis
candidata::cresson
queja::complaint
comenzó::started
existiera::categories
encontraríamos::line
siniestro::divide
murió::died
cuidadosa::poppy
atrapados::trapped
gustar::terrorists
aérea::civilians
aéreo::airlines
podían::rebels
aportar::her
natal::tiny
deprisa::running
aumentó::interest
copresidente::convene
reforzar::turkmenistan
trató::unmarried
publicados::weekend
apedreamiento::stoning
sección::section
humillante::inhuman
crímenes::crimes
formaba::statute
consiguen::graduate
normal::normal
independiente::gain
presupuestaria::budgetary
tuviese::religions
presupuestario::budgetary
carta::letter
aumente::inflation
idiomas::translated
ecus::ecu
aumento::wage
colectivo::siege
escote::gardens
iniciaron::investigations
violencia::violence
implican::involve
ingresos::offset
envía::unseaworthy
hicieron::trapped
envíe::send
correlación::correlation
limitada::voter
envío::emphasise
cualquier::any
surtido::sweden
vuelo::flight
normas::rules
estudiantes::students
luchado::environmentalists
armado::modest
armada::participated
tenencia::encouraging
árabe::secular
siglas::cesr
viajes::travel
encanta::love
foro::forum
administraciones::game
adición::addition
ford::homeless
mantiene::active
mirada::hindsight
ramas::aerospace
impiden::compete
contribuye::contributes
afectar::sensitive
afectan::fails
metropolitana::limerick
propaganda::replacing
sale::enters
adecuados::supervisory
habíamos::colours
mejoradas::improvements
legalmente::legally
apartado::paragraph
tarde::afternoon
vista::eye
aparece::voting
tarda::catalogue
académico::academia
convicción::hopeful
visto::seen
esperaba::expected
asegurar::plant
empleos::largest
alerta::sars
diez::ten
reconozco::acknowledge
publicar::fame
coronas::reserved
acercándome::feet
ejercido::noticed
poderosa::powerful
acciones::actions
dicha::correct
obras::works
noviembre::november
duplica::double
dicho::said
contribuyó::played
tesis::procyclic
armar::smuggling
armas::weapons
tienda::shop
invitados::attend
lecho::quoted
menos::less
leche::milk
primes::primes
primer::first
saben::know
pobreza::poverty
aspe::aspe
torno::transatlantic
lección::lesson
emitió::effectiveness
ocupaban::positions
libia::libyan
bahréin::yemen
reorganización::reorganisation
aporta::contributing
previo::run
secundada::rebel
escucho::fingers
dio::steps
distritos::districts
acusados::underage
apartheid::untouchability
comunitarios::mauritian
diseño::shaping
somos::we
invierte::swedes
bacterias::microbes
calcular::application
contarles::empty
yodo::thyroid
comienza::beginning
autorizado::bus
orleáns::orleans
lógico::emerged
sitúa::inflation
lógica::logic
móviles::mobile
somalia::somalia
international::respectively
refirió::spinelli
televisión::television
era::was
pregunto::wonder
agosto::lifted
reducirá::stricter
política::policy
implantes::implants
antimicrobiana::amr
clero::clergy
ladrillo::mortar
mantenerse::logged
enmiendas::amendments
científica::scientific
alto::ceasefire
instituto::institute
surgido::emerged
barreras::barriers
conservadurismo::conservatism
penalizaría::penalise
realmente::really
evaluar::assess
enorme::enormous
compatriotas::compatriots
tocar::briefly
rescatados::rescued
siempre::always
figuraba::cologne
finalizar::chapters
duda::certainly
pero::but
podido::able
cuarto::quarter
atestigua::testifies
paisaje::landscape
utilizando::passport
cuarta::quarter
acreedores::jurisdiction
malas::poor
felaciones::shenanigans
pensionistas::pensioners
ocurrido::fiji
espero::hope
espera::licensed
malak::abd
venganza::sufficiently
spinelli::spinelli
recuerden::lasting
institucional::institutional
irrigación::irrigation
gorda::blind
escocia::scotland
facilitar::shorten
comercialización::earnings
cantidad::amount
comunistas::communist
prevé::maternity
mentes::winning
sospechas::inhuman
tendencialmente::pigmeat
apoyando::gain
ido::gone
enseña::trick
concesión::licensing
asma::pneumonia
pasará::happens
maestro::proxy
perú::peru
rayo::glimmer
mar::sea
elaboró::werner
culpables::created
esperó::formal
decenios::decades
destructivo::destroys
hombre::man
integrados::everyday
mal::bad
sectores::keep
ajenas::prepared
comprometerse::commit
nour::falsifying
irrefutables::nigerian
exteriores::instructions
gradual::immune
necesitamos::need
canadá::canada
miembros::member
hombros::shuffle
delitos::documented
británicos::britons
metales::metals
inquieta::anxious
arrestado::arrested
azules::flags
esperaban::trademarks
romaní::decade
fuerte::widely
bomba::averting
trabajamos::mexican
aficionados::sports
condición::precondition
borrell::georgian
desconocidos::strangers
gestionado::strain
níger::niger
gira::novel
giro::issuing
plantearse::arise
napolitano::napolitano
decididamente::emphatically
prudencia::rationale
poco::little
nominal::roll
establecimiento::establishment
nazismo::stalinism
poca::abused
canal::muslims
pisoteando::trampling
diversas::prevailing
romano::roman
jaulas::cages
departamento::clearance
fábrica::factory
oro::golden
codeterminación::chipping
esencia::essence
amigos::relatives
geotérmica::mirrors
abdulla::ahmed
sacando::errors
venido::wreckage
derrocar::removing
ministro::minister
registrar::deplore
sesión::session
ministra::matches
ocupa::discussion
americana::fallacious
ocupe::shake
americano::conveyed
dientes::tooth
estadounidense::reversal
sienten::lived
río::rio
amonestación::reprimanded
conductores::drivers
negocio::strictly
existentes::existing
comprensión::understanding
publicará::contractor
corresponsal::johnston
daskalaki::daskalaki
repúblicas::republics
pasajeros::passenger
temprana::computers
llegará::news
discriminados::discriminated
temprano::sunday
advierto::lightly
subdesarrolladas::underdeveloped
número::number
residuos::investigators
comunista::communist
aumentan::margin
impedirles::meaningful
aumentar::increase
hicieran::advocates
sean::bold
evitación::lightly
proviene::daskalaki
corre::tricks
sinnúmero::explanations
anexionada::annexed
recomiendo::recommend
ocupó::occupied
mutilaciones::mutilations
pasamos::contributions
crió::fattened
mercados::markets
azúcar::restricted
leinster::leinster
licitación::tendering
gustaría::like
oculta::hidden
retroceso::abandoned
interior::interior
limpios::countryside
obligada::deliveries
unidas::nations
obligado::disarm
contraste::starker
éxito::success
sentó::beside
choque::collision
unidad::unit
brujas::hans
contenida::contained
logística::logistical
digno::element
preventiva::preventive
representaba::ronald
desearía::ideal
colofón::stretching
precisa::organization
preciso::philosophies
olvidar::forget
estoy::am
invernadero::greenhouse
estos::these
dice::says
sucediendo::condemn
impronta::optimistic
español::amazing
taseer::taseer
perspectivas::prospects
black::hawk
creciente::geographic
varios::several
sensato::sensible
monopolio::monopoly
niza::bang
introdujeron::invented
garantizados::confidentiality
esforzaron::kla
traduzcan::interpreters
tecnologías::technologies
desestime::codecision
alarmados::alarmed
honesto::stalinism
relativa::register
fijado::fingerprints
simplificar::simplify
museos::exhibitions
actividad::everyday
certeza::certainty
cumplido::indicated
erróneas::cannabis
municipios::formalized
afirmativa::yes
tus::negotiate
renunciar::abandoned
liberados::pose
infección::pigs
licencias::licensing
muchísimo::commensurately
adaptarse::adapted
había::had
cumplir::comply
sucia::laundry
empezar::moreover
democrático::undemocratic
democrática::democratic
ruido::advocates
resaltó::barnier
pronunció::quoted
acostumbrados::charging
teocrático::marshall
lamfalussy::lamfalussy
alcanzar::sacrifices
croacia::croatia
sensible::controversial
tercer::thirdly
caricatura::accepting
mari::mari
urbanas::urban
arte::art
austriaca::austria
industria::industry
aquellos::those
partida::starting
partido::party
correctamente::correctly
jueves::thursday
báltico::presently
sirven::good
yugoslav::rightly
fronteras::borders
guerras::wars
reconstrucción::reconstruction
diagnóstico::diagnostic
prestación::commitment
codicia::greed
energéticos::expense
preocupan::cutting
verdaderos::sufferings
presos::prisoners
acarrear::taxes
zonas::areas
encuentran::museum
autodeterminación::determination
minando::chipping
encuentras::sucked
par::couple
doctor::falsifying
paz::peace
obligar::forcing
pac::cap
hecho::done
obligan::absurd
elegida::senior
desesperación::adds
fumadores::smokers
príncipe::victor
próspero::healthy
hiciera::shaken
registradas::inadmissible
igualmente::inadequate
utilización::sterckx
disparando::rocketing
ocultando::concealing
trayectoria::defeating
desacoplamiento::incentive
gates::garage
aduanas::disarmament
transmitimos::durable
fuma::stigmatisation
bloque::unjust
estación::installation
soldado::cm
actividades::activities
contratos::contracts
atrevidas::logo
parar::yes
autocar::coach
baden::württemberg
alcanzan::absurd
redacción::drafting
puedan::forged
viven::living
seres::ones
adhesión::accession
dimiten::resigning
valona::walloon
esperanzas::hopes
estimular::stimulating
directas::stretching
descomponga::discolour
ventas::margin
imagen::image
invernaderos::mirrors
consultar::cheaply
cabe::suits
suiza::lorries
sueño::dream
suizo::swiss
inglesas::probe
fabricar::coat
criticar::criticism
critican::critics
sangriento::shenanigans
disposición::available
deseábamos::imposing
disfraz::dressing
sangrienta::imperialist
carretera::road
rectificación::voted
proteínas::protein
significativa::uclaf
notable::stretching
dramáticamente::provides
histórico::o
esfera::contribute
construcción::construction
tertulia::expecting
thabet::ahmed
zaki::abd
empresa::walloon
trabajan::graduates
delincuencia::amass
rumania::romania
monasterio::monastery
tendremos::wait
trabajar::work
teherán::iranian
pretende::intended
inaceptable::unacceptable
decisivo::preparing
pilares::pillars
decisiva::decisive
pasando::happening
esperábamos::expecting
fuera::outside
haciendo::doing
birgen::dominican
eslovaca::sociology
inquietos::fretting
ampliación::enlargement
deporte::sport
manuel::nominated
cuántos::paper
planeta::planet
aumentando::increasing
prosperidad::prosperity
contagio::originally
tratadas::worst
confidencialidad::confidentiality
desesperada::struggle
protegerla::confidential
entiendo::used
general::general
generar::biomass
prestado::borrow
field::playing
mantuvo::remained
podría::could
felicitarle::heartily
infierno::hell
órbita::iron
encontrarán::aires
respuesta::answer
condena::unequivocally
isleños::flooding
llamadas::ill
volviera::expected
claramente::clearly
irlandesa::affirmed
ético::standpoint
ética::ethical
operativos::command
déficit::deficit
cubreacov::attempts
u::abandoned
oportunidades::opportunities
epidemiológica::epidemiological
oral::oral
celebrado::referendum
bretaña::britain
celebrada::breakthrough
breve::brief
acoso::harassment
moneda::currency
ayudaría::unfair
porcino::pigmeat
viajar::travel
fidji::fiji
promesas::promises
icann::determines
pacifista::pacifist
acercarse::doors
secuestrado::kidnapped
tuvimos::had
francés::french
persuasión::persuasion
pueblo::people
integración::integration
fundadas::inhuman
judiciales::proceedings
edificios::buildings
insignificante::insignificant
contó::attempts
meses::months
pensamos::correct
reunimos::symbolises
cazados::doubtful
cargan::toll
justos::fair
incido::maintaining
perspectiva::perspective
concentraciones::excess
prolongó::prolonged
abd::abd
abe::appointment
exponer::drafted
aplicación::enforcement
determinados::penalise
ocasionalmente::occasional
molestan::bother
deleznables::repulsive
testigos::witnessing
transatlánticas::waters
existieran::burdens
varias::several
contraterrorismo::counter
visitase::javier
garantía::guarantee
demócratas::democrats
expresar::any
saudí::undemocratic
minutos::minutes
ricas::protein
acequia::ditch
africa::condom
dejaran::imagine
ampliar::broadening
expulsiones::wounds
otros::other
similitud::flemish
prestigio::reputation
prever::foresee
pobres::poor
elegantes::elegant
ministros::ministers
capaces::eminent
seguidores::followers
particular::particular
selección::wide
costearlo::passengers
guarda::library
vladimir::promising
sarcasmo::scorn
del::the
den::sweets
sacar::advantage
simbólica::symbolism
compara::preceding
iremos::honourable
financieras::colossal
cuidadores::carers
anexo::attached
prodi::prodi
danubio::crow
duración::flanders
amistad::friendship
supondrán::pose
plena::cured
oficina::office
acto::act
acta::complaint
dirijan::rostrum
pleno::unseaworthy
viena::occupying
viene::comes
distribuir::distribute
generalizar::diagnostic
sistema::system
útil::useful
desacuerdos::disagreements
soberanía::sovereignty
playing::playing
profesores::teachers
remolacha::emphasise
enfrentarnos::lie
desproporcionada::penalise
haré::spoken
conmemorar::commemorate
vendedor::vendor
ponernos::ourselves
ferho::prominent
hará::interinstitutional
recuperación::recovery
súbita::pneumonia
polvo::particles
inicios::days
estudiante::expulsion
pena::benefiting
contendientes::contenders
injustificada::institutionally
aplicarlo::broadly
resaltar::online
opción::ready
coimbra::sorbonne
oxford::sorbonne
cúbicos::württemberg
instituciones::institutions
podríamos::could
irregularidades::irregularities
visitan::aires
excelentes::wines
empiece::scheduled
formalmente::omnibus
namibia::namibia
reglamentación::worker
visitas::exhibitions
visitar::oswiecim
gramos::cannabis
mental::mental
teléfono::ambassador
carreteras::road
idea::idea
dificultades::difficulties
participante::el
referendos::hindsight
razonables::scorn
torturados::constant
transformación::shift
perro::coat
quince::fifteen
insistentemente::nationals
adecuada::organization
clásica::targeting
libaneses::complete
división::division
aportará::destruction
secretario::hoped
secretaria::letter
ardenne::ardenne
estrictamente::strictly
escenario::scenario
descomponen::microbes
universales::fore
hubiera::achieved
debatido::hotly
nace::crow
desperdicio::skills
cada::every
menospreciar::contempt
engrasada::oiled
retenidos::guantánamo
completamente::utterly
desintegración::disintegration
mama::breast
recoger::foreseeable
japonesa::japanese
públicamente::publicise
solamente::only
para::for
estalinismo::stalinism
comparación::compared
favorable::initial
believe::we
b::hepatitis
envergadura::grybauskaithas
maltrato::correlation
cambios::changes
instrucciones::instructions
judíos::jewish
compensará::offset
norteamericanos::american
atletas::screening
podamos::foreseeable
declaro::resumed
declara::undervalued
permitidos::excess
trabajos::correctly
regirse::dogmatism
conviene::suits
ruego::please
blanco::ire
infraestructura::infrastructure
discriminación::untouchability
justificada::legitimate
justificado::justified
redes::intensive
permanecen::persist
procedentes::refuge
previos::inadmissible
auge::impressive
delante::comes
reducirse::radioactivity
independencia::independence
cosecha::acquisition
permanecer::preparatory
recogidas::embracing
animales::animals
reproducir::reporting
declaró::declared
garantizará::scope
km::km
humanitarias::catastrophes
corrupto::guinean
fuertemente::hotly
sector::sector
soslaya::mitchell
thomas::owed
elaborar::primes
carne::meat
sientan::g
embarazada::unmarried
femenino::seedbed
desempeñarán::enabling
alcanza::subsidy
dependen::survival
extraordinarias::summits
pájaros::volunteers
oficiales::formal
introducción::introduction
asimismo::also
humanitaria::humanitarian
salud::health
estrella::star
expresa::voice
autónomos::predominantly
dimensión::acp
kilómetros::kilometres
esencial::essential
altura::usa
dirigidos::prodi
vino::tampere
jurisdicción::jurisdiction
individual::catastrophic
lisboa::lay
hacía::firmly
umbrales::excess
razonablemente::optimistic
elección::you
bienestar::welfare
fruta::fruit
fruto::lengthy
electoral::electoral
errores::errors
estará::agrees
estaré::shall
premisa::premise
asfixiado::locked
neutralidad::neutrality
trago::bitter
alabamos::praise
empeorar::worse
necesario::necessary
necesaria::intensive
bastaría::gdp
ocurra::happen
ocurre::happens
consume::consumed
simple::naked
lucha::fight
consumo::consumption
síntesis::synthesis
kurdo::prominent
justificaciones::justifications
reto::challenge
kurda::initiating
reformar::constitute
reformas::reforms
produjo::removed
perdió::mountainous
demasiada::too
horrenda::frf
sötét::sötét
gas::gas
demasiado::too
constituiría::abrogating
atrevió::dared
instalado::straits
ruptura::breach
repetir::petersburg
vano::vain
queden::confidentiality
regla::thumb
tareas::tasks
proyectos::projects
bill::garage
registraron::romania
sospecho::suspect
entró::walked
húngara::hungarian
fraudulentamente::fraudulently
protestaban::buzek
fui::seaside
declarar::undemocratic
darse::individual
portugal::portugal
busca::australia
luchó::injustice
distorsionar::cutbacks
remedio::chance
eliminados::liquidated
ruta::noted
basta::enough
imponer::imposing
estima::estimated
utilizables::occupational
complicar::overcomplicating
movimientos::cm
resumir::duration
entendemos::understand
seguirá::firing
caso::case
signos::sign
juventud::danish
entre::between
tasa::rate
artículos::lowered
supuesta::hypothetical
delincuentes::ahead
apoyemos::participation
últimos::last
y::and
tass::terrorists
representantes::representatives
publicó::appeared
verificar::scientific
sinclaire::sinclaire
representaban::represented
vashem::oswiecim
sustitución::engine
alternativo::fog
nuestra::our
demostrarse::included
conmovido::touched
preguntarse::whether
atentado::attempts
nuestro::our
alpes::alps
superficial::impoverishment
respeto::respect
disciplina::discipline
enriquecidos::bans
respete::guaranteeing
inició::proceeding
cisjordania::restored
respeta::morality
trataba::photograph
temporales::temporary
convocado::swiss
conmovedora::husband
costosa::specialised
establecer::established
superpotencia::superpower
considerará::sole
subrayar::stress
costoso::becomes
incendio::fire
afrontar::tackled
tratamos::helping
pirker::pirker
invertir::innovation
sofía::decade
encuentren::trouble
asignado::allocated
países::countries
crucero::cruise
vandalismo::destructiveness
nicaragua::nicaragua
controladas::misrata
mostrar::barnier
causará::limerick
laborista::icc
acusan::accusing
ártico::arctic
per::se
algunas::some
pelo::yellow
inicio::beginning
inicia::gambling
espeluznantes::severity
contacto::contact
inicie::motion
guías::directories
circulatorias::circulatory
embarcaciones::unseaworthy
justa::retail
mejorado::catches
permítanme::match
aliviar::survivors
justo::reverse
drama::stoning
detenidos::destitute
fuerzas::forces
cátedra::establish
café::ugandan
reconocidos::occupational
rodante::rolling
ponedoras::laying
cabo::conducted
limitar::pre
espectáculo::entertainment
vuelen::straight
adecuadamente::correctly
antiislamista::anti
lleguen::wait
erasmus::exchanges
poder::power
natalidad::birth
intereses::interests
máximos::emphasise
limpieza::personalities
seria::investigation
funcionado::mandate
serio::smile
interpretación::interpretation
detención::detention
drásticamente::dramatically
víctor::victor
centrarme::focus
planes::plans
encontrarse::electricity
herzegovina::financially
favorecer::constitute
favorecen::decentralization
materia::discussions
sectoriales::sectoral
significativo::exchanges
suecos::swedes
llevará::possibly
automovilismo::trophies
existía::sorbonne
ritmo::pace
enviadas::continued
apelación::appeal
representan::represent
funcionario::official
invitó::observers
procíclico::cyclical
procíclica::procyclic
desplazados::internally
corazón::heart
aumentada::workload
estanterías::shelves
hoja::myanmar
básico::element
saudita::instability
normalización::standardisation
afrontarlos::vakalis
mecanismo::mechanism
graves::serious
capítulos::chapters
perseguimos::pursue
gobiernos::governments
deseado::lose
fatah::fatah
ankara::prosecutor
totalmente::entirely
interacción::interplay
registros::searches
visitantes::visitors
petición::originators
musulmanas::clergy
militares::military
deslumbra::downwards
deficiencias::emerged
galletas::shortbread
barnier::barnier
buques::vessels
resultaba::agonising
originales::original
inglesa::maintained
combinadas::burundi
grados::degrees
contratista::contractor
ciclo::cycle
acceso::access
armadas::command
corazones::hearts
podrán::able
rehenes::unequivocally
presidencial::defeat
espejos::mirrors
mauricio::mauritian
construyendo::federalist
década::mid
sino::but
extremo::easternmost
párrafo::paragraph
extrema::extreme
encarcelados::imprisoned
radiodifusión::broadcasting
arrestos::searches
defensores::defenders
perdedores::losers
necesarios::necessary
serbios::expelled
clima::climate
descrito::dilemma
honor::honour
dedicaría::devoted
individuos::individuals
escoceses::danes
perpetrado::fiji
tunecino::tunisian
fracaso::failure
presidenta::madam
lenguaje::language
intenten::destroy
distribuido::distributed
importaciones::imports
insultemos::hurling
precisamente::precisely
gastaba::constituents
nobel::nobel
misiones::missions
ofrecerles::conducive
respetaban::rebels
fracción::occurrence
estalle::bursting
desencantados::becoming
estallido::outbreak
soberana::cyclical
pagado::disarmament
corporaciones::consortiums
creyó::originally
iii::user
manifestarse::motivational
primeró::favour
admitido::offering
restantes::chapters
mesas::meant
puramente::abrogating
ravenstein::ardenne
extranjero::abroad
do::what
extranjera::languages
retenido::gunpoint
seísmos::vakalis
compostela::compostela
dedican::game
acp::acp
jurídicos::legal
clínico::clinical
stock::encouraging
de::of
falta::require
berlín::berlin
fuertes::personalities
husein::hussein
preocupa::smuggling
fehacientes::tenable
espectro::spectrum
restaurantes::satisfying
estimulado::emphasise
l::holdings
tecnológico::enabling
tecnológica::shift
pacotilla::dictator
primera::first
unido::uk
solos::quebec
unida::peculiar
primero::first
regresión::regression
delegar::downwards
gogh::colours
meter::foot
visados::visa
meten::toy
absolutas::absolute
fabricación::cosmetics
santiago::santiago
realidades::realities
le::you
la::the
conquistó::grace
lo::what
labor::depended
lt::marketplace
evaluado::evaluated
confío::handle
flujos::migratory
avergonzada::ashamed
dan::normally
cual::exception
fiesta::festival
equilibro::dozen
dar::feed
ginebra::geneva
qué::what
lanzamos::hindsight
mandato::cresson
recuerda::reminds
recuerde::listen
recuerdo::remember
morris::respectively
prioridades::priorities
acabamos::broken
permitido::allowed
bueno::good
diferir::differ
almacenes::stocks
buena::good
suministra::except
gargani::background
sexual::sexually
lituanas::lithuanian
suministro::chain
sudeste::england
rey::king
jurídico::legal
cajero::dispensers
jurídica::wealthy
orientar::examples
sooronbay::kyrgyz
posteriori::niger
oriental::eastern
generosidad::generosity
mata::papilloma
regionales::regional
red::network
afirmarán::contend
aturdidos::stunned
exige::requires
que::that
anonimato::confidentiality
compra::bought
asumir::role
necesariamente::necessarily
estados::states
idioma::served
tráficos::amass
emana::emanating
mortal::deadly
trágico::tragedy
saca::syria
deteriorarse::refuse
realizados::conservative
aspiran::admits
detenciones::arrests
detectar::screening
discordia::specialist
repitan::recurrence
estúpido::stupid
próximo::next
cintas::stars
próxima::sitting
peijs::peijs
lamentable::regrettable
palestino::palestinian
compartido::kuhne
cuál::what
interesados::interested
espejo::mirror
palestina::palestine
progresos::progress
discutir::exchanging
negra::forest
agigantados::upsurge
huseini::stoning
elaborando::utterly
negro::black
saldrá::original
acotaciones::suggest
sabido::praise
aspiraciones::trampling
llevan::table
asean::ties
llevar::wear
extraordinariamente::tragic
trasladado::shifted
maleta::gdr
propuesto::proposed
terribles::horrible
sacó::hans
fascista::racist
propuesta::proposal
mil::billion
restablecimiento::promising
solían::constituents
mis::my
azucarera::emphasise
exposición::premises
fingir::pretend
disponen::car
prestaciones::wages
serenidad::midst
obtuviera::fullest
monetaria::irony
monetario::monetary
altos::organic
usuarios::users
máximas::profit
segura::remunerated
seguro::sure
nicholson::nicholson
sostenido::maintained
armadores::shipowners
lamentaciones::wailing
navales::focused
acogimos::testimonials
elevados::maternal
equipos::teams
insultos::retreated
viceprimer::gazprom
acojo::involvement
entramado::figment
particularmente::surrounded
fecha::date
normalmente::normally
inferior::lower
obviamente::obviously
inmensa::immense
inmenso::rely
mochila::normally
embajador::ambassador
aproximadamente::approximately
repuesto::spare
ganan::post
oscuro::dark
ganar::exploited
ganas::keen
ventajas::advantages
resultante::controversy
desempeño::ngo
grosso::unity
aplaza::rescheduled
desempeña::plays
we::we
existe::there
conducción::driving
expensas::expense
exista::transposition
progreso::augurs
musulmán::gaining
tuvieron::frf
transeuropeas::rapprochement
precedente::precedent
hacerse::proper
lengua::language
reunido::jury
estimación::households
murieron::networks
avanzar::vision
afrontado::germans
armenia::yemen
tabaquismo::passive
electorales::electioneering
ofrece::incentive
francochamps::formula
utilizan::mining
conseguir::achieving
públicas::public
iniciativas::overcomplicating
causó::horrible
propietarios::owners
asesinadas::clashes
balcanes::balkans
fassbinder::fassbinder
orientación::orientates
defensora::defender
hijos::children
mafia::curse
climática::rely
electa::arrest
electo::stations
climático::climate
dependan::unfavourable
ayudó::helped
revisten::disagreements
discusión::insoluble
reclamaciones::continued
catálogo::catalogue
pudimos::occasion
prometiendo::promising
locales::local
pasaporte::passport
pronóstico::forecasts
hubo::reached
república::republic
notificar::confidentiality
virtual::derivatives
multa::frf
empeoramiento::journeys
católicas::catholic
deben::must
analizar::negligence
notificó::notifying
eficaz::effective
hambruna::starving
escrutadores::rostrum
arabia::saudi
deber::duty
analizan::supermarket
flexibles::flexible
electores::constituents
extienda::restored
destruyen::shipbuilding
tiempo::time
creemos::create
asociación::partnership
maravillosa::celebration
abejas::bee
sigue::still
participaron::reappraisal
incluya::migrant
constituir::platforms
paredes::sötét
resultado::results
siguiente::follows
centrado::focused
inmunodeficiencia::hiv
afortunada::accidents
pendiente::directories
rescatando::volunteers
reciben::burmese
pasear::bar
fetal::psychiatric
apropiadas::fraudulently
votación::vote
emplean::occurrence
asociaciones::associations
gyanendra::starker
sandinistas::ortega
policía::police
quiero::want
quiere::wants
quiera::bandwidth
perseverancia::thanking
felicitarlo::celebration
transición::transposition
exención::exemption
insatisfecho::customer
lleno::hell
tests::diagnostic
llena::full
paralelo::untouchability
acercándose::forefront
quebequenses::quebec
ejemplares::copies
partículas::particles
aparecido::accusations
existan::maybe
desarrollo::development
dubai::dubai
américa::america
transferencia::criticised
estallado::fatah
tomó::took
desarrolla::implemented
terminaron::cotonou
ruinas::ruins
aprobará::cesr
ponentes::rapporteurs
euforia::euphoria
inauguración::opening
referente::relating
producirá::supervisory
otras::other
huelga::strike
terapéuticos::cloning
solitario::cope
entradas::meantime
gravámenes::taxes
reglas::overhauling
innovadores::imitators
adicional::comment
cálculos::epidemics
rapkay::rapkay
pues::therefore
farmacéutica::pharmaceutical
formación::lifelong
ese::exercise
experiencias::evaluate
esa::that
eso::that
cuestan::cost
tras::after
empezado::started
lanzarse::reaches
tranquilice::reassure
electrónico::mail
simples::wanting
estimado::fabre
actual::current
abogados::lawyers
protegidos::protected
generadores::wind
toma::decisions
actuar::act
desarrolló::parmalat
invadió::invaded
sustituidos::replaced
falsificar::forged
estaban::shut
duró::dream
biológica::preserving
comido::eating
doradas::stars
libremente::freely
entidades::credit
comida::food
sexuales::mutilations
apartamento::husband
cesare::battisti
embargo::however
responsabilidad::responsibility
jefes::heads
excolaborador::fazakas
apoya::wellintentioned
duro::suffered
reconocido::recognises
defendamos::tooth
suprema::housel
supremo::supreme
periodo::period
pib::gdp
pie::ordinary
dura::severely
hamás::hamas
invadir::invade
manifestantes::russia
paraguay::paraguay
haider::haider
periódicos::newspapers
motores::vehicle
fórmula::formula
empresarios::entrepreneurs
encontré::met
estableció::introduced
granito::her
encontró::fraudulently
tecnología::technology
investigación::research
anteriores::contrast
considerémoslo::tried
eliminación::environmentalists
aceptable::acceptable
cheque::rebates
millones::million
asisten::attend
philips::garage
turistas::tourists
ningún::no
accidente::accident
original::original
distintas::different
limited::respectively
schengen::schengen
limiten::chairmen
pide::selecting
bálticos::baltic
tratar::try
tratan::wives
intensamente::target
negativamente::adversely
visitarle::mehdi
compañía::company
vuelan::wrap
destinados::transmitted
cuota::reserved
interestatales::disputes
madera::warmer
apareció::disturbed
representados::coordinating
vuelas::sucked
terceros::third
estallar::volcano
estrechas::disagreements
retroceder::backwards
enérgicos::bold
casan::together
entregue::gdańsk
espacial::space
casas::houses
hungría::hungary
cámaras::grandmother
decidir::enters
chantaje::blackmail
ilegales::illegal
maternidad::maternity
cappato::cappato
peores::worst
banderas::flags
parten::proceed
bienvenida::welcome
vayamos::transferring
partes::parts
ficción::conjuring
kivu::internally
ellas::them
sonda::probe
conduce::directives
impulsor::stability
cuarenta::roads
fuerza::try
pesticidas::prostate
enfrentan::face
organismo::body
relativamente::relatively
práctico::implications
preferible::religions
contribuyente::santa
preparan::prepare
averroes::brilliant
práctica::practice
preparar::possibilities
capítulo::chapter
aceptaran::nationals
beca::hawk
norteamericanas::irrespective
maldivas::ambassador
decidió::decided
dólar::dollar
ventures::ventures
desapareciendo::ease
precio::price
estatales::shut
negros::walk
parlamento::parliament
relacionado::connected
desalinización::irrigation
julio::july
hablan::retirement
semanas::weeks
infantil::pornography
oxígeno::microbes
norteamérica::consortiums
visible::logged
configuración::acp
permitía::exiled
sacaría::clones
hablar::speak
consiguió::removing
hospital::hospital
decente::dread
mineros::mining
ignorancia::ignorance
saber::know
sabes::negotiate
socialdemócratas::democrats
regulaciones::fraudulently
acceder::workplace
empiecen::winning
significado::explaining
me::i
contentos::nevertheless
atómica::atomic
mi::my
musulmanes::followers
vagas::vague
político::political
recambios::invent
invierno::winter
creación::creation
subcomisión::hearing
propuestas::proposals
interurbano::reflected
uzbekistán::uzbekistan
ambos::both
soñé::vip
arrancan::slow
mención::noteworthy
kroes::specialist
essen::essen
plantando::averted
gato::pulling
autenticidad::genuine
traiga::stand
evitemos::stigmatisation
especializado::brutal
costes::costs
mesa::table
especializada::specialised
mí::me
diría::frame
plaga::scourge
evocarlo::dangerous
naturaleza::nature
suerte::enemy
adquirido::acp
inseguridad::criminality
fracasando::continued
madres::lone
núm::kla
reloj::turned
lácteos::fraudulently
presupuesto::budget
enseñar::teaching
orgía::borrowing
bombilla::garage
preindustriales::pre
traer::rescued
singapur::singapore
origen::origin
pluralismo::pluralism
vueltas::total
existen::there
ingeniería::engineering
dirigente::leaders
peligrosos::dangerous
musulmana::muslims
expedientes::centralised
bosnia::financially
pescadores::fishermen
doblado::norwegian
habiéndolos::firing
histórica::crossroad
estrechamente::seedbed
injusticia::injustice
intentado::tried
prohibir::ban
macroeconómico::japanese
extremos::liquidated
reservas::reserves
reservan::reserved
conceptos::destructiveness
cancelación::settlement
molestia::bothered
bioquímicos::biochemical
kuwait::kuwait
nunca::never
redujo::reduced
matar::ak
útero::womb
auspicios::auspices
estableciendo::increasingly
temporal::temporary
verdadero::breakthrough
verdadera::brain
planificación::planning
ridiculiza::ridiculous
entregado::baton
resistencia::resistance
deliberados::deliberate
suburbio::milan
dirigidas::following
contaminación::pollution
actuales::immensely
preferencia::preference
aspira::actor
devastador::revelations
intentar::trying
muralla::wailing
desmembración::collapse
industrial::industrial
eslogan::slogan
manifiesto::severity
drogas::drugs
palpable::households
estemos::dictated
industrias::industries
homosexuales::subway
explicación::explanation
sufriendo::brain
coacción::compulsion
costarles::disclosure
quinto::confronting
stephan::bundesnachrichtendienst
americanos::americans
quinta::fifth
probables::conserving
amablemente::respective
obstruir::clogging
inconveniente::perceived
ligeramente::moved
circunstancias::circumstances
pendientes::clergy
denominada::called
denominado::cannabis
protegidas::designations
bombardean::complain
fyrom::rightly
moralidad::morality
agricultor::cages
ram::amr
cooperación::cooperation
efecto::effect
parajes::conserving
desplegó::widely
ignorar::globally
aquellas::incomes
erróneamente::inadvertently
fácilmente::easily
tratado::treaty
concebir::educate
empezó::schoolteacher
gitana::incidentally
apartados::seq
encerradas::cages
invitación::rebates
cifras::figures
phn::nhp
markovic::markovic
instrumentos::instruments
obvio::physicians
conjuntamente::mexican
gángsters::gangster
cambio::change
hígado::diabetic
evaluación::consistently
cambie::discolour
cambia::telephone
vivimos::protectionism
tejidos::excess
apocalíptico::scenario
milán::milan
radio::terrorists
él::him
rector::vanunu
coronel::dictator
domicilio::terminal
calculado::calculated
hacerlo::do
ocm::coms
hacerle::counter
lograda::fait
atractivo::researchers
atractiva::attractive
logrado::advanced
camiones::lorry
viviendas::residential
genocidio::concentration
fontaine::fontaine
escritor::said
observaciones::comments
watch::watch
gobernador::governor
banotti::handle
manifestando::declaring
limitación::restricted
dejaremos::top
richey::arson
ponente::rapporteur
dependiendo::sun
lleven::commemorate
legión::heartily
cable::cableway
castigarse::infringement
liderado::adolf
inspecciones::safa
kinnock::abolishing
recientes::village
iglesia::church
maletas::packed
idénticas::identical
construirán::investors
helcom::presently
hambre::disarm
muy::very
ríos::rivers
empezamos::beginning
vivos::colours
absorción::absorption
dormía::surprising
antes::before
vale::benefiting
alimentarios::expense
concretos::begun
terreno::ethical
ferroviaria::comprehensive
demostrar::deserves
justificar::justify
encarga::primes
capturan::dover
epidemia::epidemics
privacidad::constitutionally
sanciones::sanctions
capturas::mackerel
hitler::hitler
hijo::son
aviación::aviation
repetidas::documented
domino::walking
pulmón::lung
tenemos::we
ofensa::offence
encarcelado::convicted
tiflis::tbilisi
implica::financial
fuego::ceasefire
atenderlos::carers
xxi::st
firmeza::strongly
sinceramente::frankly
reducir::reduce
implementación::shuffle
fallos::confidentiality
directores::fortune
brote::sars
experto::expert
autores::originators
trajo::breakthrough
frutas::fruit
exterior::foreign
étnico::persecuted
hipocresía::hypocrisy
invitaron::dinner
supervisión::inspectors
autobuses::watched
entregada::quarters
presencia::presence
apague::burn
bolonia::sorbonne
métodos::methods
sindicatos::trade
candidatos::candidates
infancia::york
récords::traders
dado::meijer
aún::still
construyamos::gain
alarma::avail
dimos::given
desagradable::distasteful
rociadores::gdr
alimentos::food
olvidada::minority
quedó::unmarried
especialmente::especially
quedado::crippled
copiar::accepting
complejo::complex
compleja::complex
ambas::both
excluyente::philosophies
notificarlo::clinical
conseguimos::disappear
mencionado::available
disolución::dissolution
escuchar::anthem
civilización::civilisation
donar::donate
culturas::cultures
cultural::cultural
aprender::learn
curar::cured
huevo::cages
banda::bandwidth
tamaño::enterprises
rumor::tricks
serbias::tricks
conmigo::requisite
contradice::receive
honestidad::honesty
unión::union
bandos::armies
cuadros::scoreboard
rodaje::imagine
influir::influence
copiarles::emulate
buenas::good
alemán::german
comparamos::inadmissible
dónde::where
tendríamos::probably
visitado::busy
lukashenko::lukashenko
oponerse::oppose
riesgos::risks
musharraf::musharraf
kuhne::kuhne
violentos::violent
búsqueda::roots
estuvieran::coordinating
encima::above
suelo::soil
automóvil::vehicle
suele::always
nuevas::new
acababan::occupying
renovación::shipowners
esperan::expect
sepa::parent
duele::memory
gobernanza::governance
serán::irrespective
algo::something
misma::same
mismo::same
esperar::wait
yacimiento::archaeological
encuentra::impasse
encuentre::baby
civil::civil
conocer::fortunate
encuentro::exploit
desapariciones::caucasus
tribuna::gallery
convención::convention
requeriría::necessitate
carácter::cyclical
entendía::odd
presidencia::presidency
parlamentarias::neither
indispensable::areas
especulación::speculation
aéreas::airlines
asiático::asia
sistemáticamente::systematically
antemano::answers
salvaguardar::guaranteed
conducir::seven
moratoria::lifting
tronchada::württemberg
indicado::signalled
domésticos::investigators
reales::real
buckingham::palace
populismo::populism
sufre::indigenous
tengan::unblemished
vive::live
plataforma::incidentally
vivo::custody
mejorar::improve
sospechoso::fazakas
francamente::opposite
supo::scene
penal::criminal
ahí::hence
someterán::böge
checa::czech
juntos::together
propia::own
nicolás::santa
junto::alongside
contaba::lawyers
no::not
brutales::brutal
derecha::indicate
llueve::sumatra
techo::homeless
ciudadanos::citizens
típico::unintended
cayera::cup
solana::javier
típica::typical
entenderá::understands
siente::feels
introducir::socialism
intachable::unblemished
siento::hostage
varones::sex
levantan::twelve
exigencia::abandoned
vietnam::vietnam
pauta::pattern
ofrecerle::dozens
comunidad::community
presentarse::neither
recesión::autumn
vecinos::neighbours
justificarlo::hard
agrícola::agricultural
peticiones::viii
residuales::erdf
ibrahim::ibrahim
fallecieron::passed
edad::age
idealista::idealistic
topamos::communication
level::playing
transdniéster::transnistria
debatir::p
flexibilidad::flexibility
informados::informed
compradores::buyer
deberían::should
quede::intend
estanques::traces
embajada::gesture
constituyentes::split
totalidad::tenth
minoría::minority
irlandés::founding
método::functionalist
referéndum::referendum
enfermedad::disease
preocupantes::symptoms
simbólico::gesture
automóviles::inherently
convenio::auspices
constituirá::splendid
asaltado::broken
aunque::although
concluyo::make
tire::regardless
culpa::fault
votado::voted
élite::elite
dichos::these
equiparable::seventies
estadio::stadium
garaje::garage
patrias::poetically
parma::viareggio
excluir::ruled
empleadas::undervalued
acortar::shorten
crisis::crisis
pasarle::pass
desgraciadamente::unfortunately
arriesgada::institutionally
vivir::live
todas::all
abuelos::myself
criterio::criteria
cobrado::dirty
implicados::involved
aplica::engineering
arrojado::investigators
libre::free
servirá::recurrence
botella::bottleneck
detalle::explanations
tribunal::court
exponencial::exponentially
descubre::discover
autónoma::tamil
realizadas::mattel
valle::valley
valla::fence
ampliarse::driving
figura::consistent
figure::pleased
construir::build
desierto::ocean
sumergido::insurgence
intercultural::celebrating
sagazmente::denounce
nubes::surprised
ofreciéndoles::offering
exposiciones::exhibitions
israelíes::israeli
vivieron::lived
viendo::watching
rubio::yellow
vital::vital
atesora::amass
fundamento::base
cómodo::iron
preocupado::federation
informe::report
refuerzo::enhancement
posibilidades::broadening
mediados::mid
tiránico::hussein
cuantos::transactions
determinado::physiotherapists
aburre::boring
garantizar::ensure
asesinato::sarajevo
donación::donation
descubrí::poles
aviones::straight
dilema::resolve
olvidarnos::tax
manera::way
exclusiva::wanted
aceptó::newcomer
hipotética::abrogating
inversores::investors
diversos::clashes
aduanero::taiwan
ronda::round
federalistas::federalist
alcanzará::represented
monetarios::hearing
bruguière::counter
modificarlo::sensible
instancias::downwards
novia::emigrant
facturación::charging
humanitarios::suspend
registro::actively
simpatías::sympathy
tobacco::respectively
opera::operates
daba::looked
observación::defenders
gustó::pleased
muchas::many
rápida::swift
gordas::boring
destacado::signing
distinta::turns
étnicas::drafting
visitante::user
restaure::restored
acepte::accepted
cargos::charges
consideraciones::rapprochement
acepta::youth
sometidas::exponentially
satisfacer::greed
simplificarlo::sensible
producción::production
vejiga::bladder
denominaciones::designations
haberse::subjects
consta::films
herramienta::tool
refrán::fingers
migrar::coming
competencias::skills
costas::florida
gusta::latter
querían::wanted
abordó::greek
empezando::unequivocally
inventó::garage
gusto::lived
enfrentarse::tackles
falsificado::wasted
utilizarse::absorption
convenios::complied
romaníes::camps
procedimiento::insolvency
airbus::airbus
meticulosa::downwards
opusieron::unionists
basada::diabetic
basado::radicalisation
insulina::insulin
más::more
inmigración::immigration
encrucijada::crossroad
contribuir::durable
montenegro::montenegro
alan::johnston
pretendía::intended
oradores::speakers
ochenta::met
votaron::duma
ferrocarriles::railways
djibril::djibril
contamos::acquired
rebajar::mountains
enérgicamente::unequivocally
and::ernst
bancaria::appointment
nombrado::nominated
parlamentarios::assistants
once::eleven
ideas::ideas
malta::malta
ideal::ideal
probablemente::probably
terrorismo::terrorism
azores::azores
intermedio::truth
pedirles::asking
fallo::fault
soluciones::they
liderar::chair
arqueológico::agonising
laboral::labour
será::will
admisibilidad::admissibility
salida::impasse
austriacos::unionists
hurones::ferrets
permiso::maternity
tráfico::trafficking
riqueza::wealth
mercado::market
supervivencia::survival
hace::ago
escena::reinforced
nadie::no
infravalorado::undervalued
desee::cable
adopción::adoption
deseo::wish
suponía::prosperity
distinguidos::differing
cierran::carrefour
prueba::test
dotación::uclaf
escombros::pile
toca::controversial
masas::inevitability
certificados::certified
posibles::survivors
rutinarias::enable
doble::wonders
sugerencias::suggestions
carecen::stronger
médico::rigorous
pekín::beijing
médica::imagine
llamado::globalisation
presenciar::lorry
escuchamos::accusing
sirio::syrian
siria::syria
intimidación::intimidation
supondría::transactions
dirigida::letter
lituania::lithuania
auditoría::audit
dirigido::enterprises
índice::index
equivoco::novel
federal::federal
equivoca::mirror
puntos::points
inesperadas::unexpected
experimentos::cosmetics
exigencias::besides
dinero::money
atmósfera::atmosphere
instándoles::urging
como::as
proponer::propose
deportes::sports
manifestado::considered
reconoció::transposition
anule::abrogating
enésima::th
quien::whoever
detener::stop
color::discolour
neerlandés::dutch
por::why
acaban::unused
batalla::battle
acabar::brief
werner::werner
colon::bowel
empresarial::business
polo::monetary
inútil::pointless
revisión::review
registrados::record
obstáculo::obstacle
orissa::orissa
preciado::conducive
disponía::invade
protocolo::protocol
chávez::politicisation
asuntos::affairs
andrew::symeou
conozco::prosecutor
intenciones::intentions
tamil::tamil
gesto::gesture
voluntaria::underline
hughes::transposition
vínculos::arises
casa::home
propio::own
prematura::enthusiasts
eminentes::eminent
casi::almost
entrega::boycotted
incidentes::exactly
situación::situation
impensables::unthinkable
traficantes::punishments
turquía::turkey
antisocial::destructiveness
tensión::tension
vuelos::flights
checo::affirmed
aeropuertos::airports
fácil::easy
evento::event
golpe::coup
vivían::constituents
alimentado::fed
comparten::pragmatically
sencilla::theory
inequívoca::unequivocally
inequívoco::occasion
isla::island
todos::all
fundación::founding
desfavorecida::complete
persona::person
rechazadas::académie
ni::not
entonces::then
director::director
directos::immune
valorar::panshir
finalmente::finally
transcurso::tendering
mantenga::feature
miedo::bar
acorta::rescheduled
mantengo::organizations
casó::amina
redactado::hallmarks
protege::intervening
proporcionada::proportionate
llegaron::served
enfrentará::conservatism
politización::politicisation
abandono::accusing
laboratorio::laboratory
señalado::priorities
avión::crashed
destaque::highlight
batería::cages
forestales::fires
celebraron::summits
delhi::delhi
llegado::reached
carencias::shortcomings
población::population
tanto::therefore
tanta::distasteful
tratando::omnibus
abrigo::coat
chernóbil::chernobyl
humildes::humble
turco::marshall
interesante::interesting
diputado::persuasion
evitando::avoid
madrid::madrid
perseguidos::commit
turca::invasion
inadmisible::carry
servicio::service
vacunación::controversy
legal::ticket
sugiere::produces
proceder::caution
sugiero::establish
dicen::petroleum
alrededores::investigators
tradicionalmente::traditionally
desmantelamiento::disarmament
polaco::kidnapped
polaca::polish
científicos::scientists
censurar::web
intención::intention
of::european
constato::noticed
tepl::monastery
constata::relate
dedos::attitudes
obrero::shipyard
demográficos::elderly
determina::determines
instrumento::instrument
verán::neglected
inestabilidad::instability
llevarse::reorganisation
unas::nurses
trabajado::worked
tacto::requisite
nombres::name
moscú::moscow
unan::join
parlamentaria::parliamentary
excepcional::outstanding
ewing::ewing
espontáneamente::creates
desarrollada::worker
transitables::workplace
demostrando::sparingly
inspección::inspection
artículo::article
último::finally
naturales::natural
informarse::cable
langport::southwest
orejotas::ukip
usted::you
desapercibido::unloved
divergen::diverge
piensen::thought
correspondiente::allocation
concedámosle::broadly
funcionarios::officials
rápidamente::quickly
nigerianas::nigerian
visado::reasons
tierras::acquisition
oleada::wave
someteré::smith
actualizadas::slogans
grupo::group
directora::bnfl
largas::lots
transporte::transport
calle::street
oportunidad::opportunity
fatales::bar
obtenidas::evaluate
peligroso::dangerous
accidentes::accidents
ali::ahmed
fuente::source
fijados::missed
ala::spare
separan::separate
oscuridad::ages
disfrutaba::bet
expertos::experts
bajado::wells
existir::explanations
libertad::freedom
agotador::coach
sufrimiento::suffering
filtran::suspect
adquisición::acquisition
conocimiento::differs
dirigir::directing
admisibles::inadmissible
judicatura::coups
poblado::forthcoming
esfuerza::striving
derechas::pensioners
socios::partners
intentando::superiority
esfuerzo::effort
reino::uk
canaliza::determines
basura::dustbin
asequible::reasonable
reina::claims
milosevic::markovic
what::what
maoístas::maoists
adecuado::socialism
raíces::roots
accedieran::chamber
suu::aung
importes::lines
sus::their
sur::southern
autodefensa::stun
vamos::we
posiciones::jobs
detectado::transboundary
eficacia::considers
excepcionales::occasional
tőkés::representing
dedicado::chapter
balanza::unfavourable
alquiler::ardenne
naval::shipping
conseguido::done
evitar::avoid
perdedor::boeing
testigo::baton
trabajador::worker
sabía::knew
alternativas::mirrors
peligros::dangers
confidencial::confidential
palabras::words
inspectores::inspectors
resolver::resolve
texto::text
allianoi::allianoi
reactores::occurrence
administración::administration
cárceles::prisons
filosofía::philosophy
provocar::mistaken
periódico::newspaper
oyó::soldiers
oírse::indication
trabaja::identical
huecos::plug
tenían::lucky
trabajo::work
antiestadounidense::marshall
permanente::intelligent
israel::israel
comenzado::starting
celeridad::swiftly
muestren::nigerian
mire::wide
internacionales::international
globalización::globalisation
técnicas::bladder
preocupación::breakdown
dedicamos::appointed
porcentaje::percentage
condiciones::conditions
verano::summer
regímenes::regimes
debates::debates
esperanza::hope
entregados::trophies
plenamente::fully
irregular::smuggling
participantes::participants
iniciar::clinical
azul::stars
equivoquemos::mistake
inicial::drafted
pone::sky
trabajó::worked
cuestiona::holdings
buenos::good
vlad::attempts
pertenencia::belonging
diferentes::different
radiactividad::radioactivity
cambiaron::changed
actué::grandchildren
parte::part
digitales::digital
encargan::discussion
dentro::competence
grande::large
experimentado::downs
motivación::motivational
intervino::reacted
esconde::rebates
instalaciones::survival
hamburguesa::clones
interponer::organization
respiramos::breathe
tomarse::lightly
negocios::latter
domiciliario::arrest
enormes::enormous
ciertamente::incarceration
significativamente::contributes
pornografía::pornography
argentina::argentina
crecer::grow
consecuencia::result
enmienda::amendment
protección::protection
inversiones::invest
aclarar::resolved
realizaré::comment
fallida::reflected
ausencia::absence
daña::harms
mantener::maintain
daño::harm
pedido::compatriots
incidencia::greatly
tintas::toll
socialismo::socialism
soledad::boredom
entorno::environment
suprimiera::abolishing
microgestión::downwards
anápolis::preceded
financiada::funded
alcohol::alcohol
significa::means
financiado::primarily
nepal::nepal
clandestina::assist
causado::caused
región::region
bloquean::impinge
rostro::abd
huido::run
pequeño::small
inhumanidad::oswiecim
pequeña::small
comunicar::mehdi
reanudado::resumed
senado::senate
árboles::trees
garantizado::municipal
obra::brilliant
pastillas::thyroid
introducido::wonderful
deje::persuade
nosotros::we
líderes::leaders
deja::standardisation
dejo::intend
permitirnos::continued
hogares::wells
defecto::defect
ciento::cent
relata::tracing
corporación::determines
contribuyeron::decisive
colombia::colombia
inscritos::fifteen
concurso::sympathy
temperatura::temperature
contra::against
esas::these
visibilidad::visibility
molesta::disturbed
decepcionante::urging
misrata::misrata
obtención::ecb
malentendidos::misunderstanding
conciencia::pacifist
acogida::worker
hotel::hotel
sarkozy::summits
treinta::thirty
duplicado::seekers
seriamente::serious
referirse::applied
imágenes::pictures
divisiones::divisions
habilidades::skills
gala::officially
abrirse::scene
tremendamente::terribly
eurogrupo::benchmarks
ucranios::wasted
delictivo::slip
poner::curb
violar::escalate
parece::seems
poned::slogan
contractual::differing
cobran::ugandan
ponen::severity
nivel::level
tuve::had
cargo::his
pertenece::prepare
tuvo::obtain
exclusión::civilians
encargado::leave
difíciles::harsh
obstáculos::obstacles
organizaciones::organisations
retraso::delay
revolución::revolution
agotándose::drying
mortero::mortar
kosovo::kosovo
superar::inhumane
explicado::clarity
eslora::owners
saludable::healthy
superan::excess
situados::ethical
publicado::published
hielo::ice
provincia::leinster
ocupadas::jobs
jugar::playing
modificando::constitutes
recordásemos::cultures
porque::because
hablando::talking
identificado::traces
señalar::demonise
mía::oh
tratamiento::treatment
dejarla::leave
dejarlo::difference
oświęcim::oswiecim
depuración::overshot
sonares::focused
insolubles::insoluble
pleito::owed
accionista::gazprom
contrarrestar::daphne
catastrófica::catastrophic
defensa::defence
controlarla::robot
versión::original
reuniones::meetings
organismos::consultation
licenciarse::graduate
consecutivo::sixth
solo::only
proyectar::fortress
silicona::implants
sola::shoulder
razones::reasons
solucionar::solve
posesión::his
presión::pressure
ligado::linked
militantes::constant
c::pre
confiere::assignment
considerar::evaluate
asunto::subject
declare::session
procedente::uninterested
operar::burdens
consideran::shoulders
concluye::siege
reside::irrigation
fantástico::shadow
legitimidad::acknowledge
pasadas::rulings
ideología::gaining
juntar::frf
juntas::emis
cierta::certain
portuguesas::portuguese
llamarse::gangster
java::sumatra
variedad::plenty
pl::pl
mugabe::mugabe
sucumbido::dirty
cuestores::urging
conversaciones::wailing
botín::yellow
cinco::five
kirguistán::annexed
instructor::alps
gubernamentales::cutbacks
proporción::proportion
württenberg::württemberg
marcha::march
teníamos::importing
hablado::talked
abierta::open
planta::palace
anticipos::declarations
acuerdo::agreement
rebajarnos::demean
invasión::invasion
abierto::open
imposibles::screening
periodistas::journalists
cáncer::cancer
espacio::space
demos::enough
deliberadamente::deliberately
mostrando::showing
investigaciones::research
ugandeses::ugandan
fueron::were
factible::feasible
reestructuración::aerospace
atrás::back
estigmatización::stigmatisation
predijo::snowfalls
sufrió::blow
fechorías::denounce
requieran::specialised
oponentes::elimination
apenas::lived
categoría::planned
haga::short
orientaciones::guidelines
tortuga::tortoise
hago::campaigning
estimamos::acceptable
indudables::insurgence
tropas::troops
ganando::gaining
capacidades::sars
precedentes::unprecedented
presionar::chamber
quema::burning
supervivientes::survivors
inocente::innocent
técnica::cloning
moverse::stuck
técnico::budgetary
anunciado::expecting
pasivo::passive
suelen::racism
arriba::suspect
accesibles::dusk
truncados::wreckage
enfermedades::diseases
ridícula::ludicrous
volver::return
ciencias::sciences
habido::undeniable
sencillamente::simply
destaca::emphasises
niño::child
penitenciaria::sentences
niña::girl
manifestación::demonstration
revelan::trends
semana::week
recordarles::weekend
repitiéndose::repeated
luchando::silence
liebre::pulling
dedicaremos::devote
aptitudes::qualifications
racista::racist
derwich::prominent
medi::fake
pros::cons
tampere::tampere
sirvieron::fallacious
causadas::markedly
ojos::eyes
anne::engage
anna::liquidated
afortunadamente::wonderful
campañas::electioneering
queremos::want
escenarios::conjuring
mejorará::hussein
asombroso::amazing
martin::martin
nuevo::new
zelanda::sheep
intensa::intensive
nueve::nine
nueva::new
plazo::term
ignoró::ignored
antiguas::salute
plaza::buzek
sindicato::seconded
agradará::west
amargo::bitter
rango::ranking
disponga::gets
autoayuda::concepts
mutuo::libya
representamos::represent
nocturnos::discussed
primeras::stretching
forzada::prostitution
entusiastas::enthusiasts
mejorarlo::sensible
enfrentados::helpless
produjera::drift
actuando::paraguay
dándole::total
predicar::teaching
comprometido::committed
absolutamente::suicidal
fase::phase
disminución::bee
desarrollados::debauchery
familia::family
delta::crow
restricción::restriction
cumbres::summits
calles::streets
revocación::reversal
apremia::pressure
temperaturas::snowfalls
millas::mauritian
liberarles::blackmail
inventaron::monastery
áfrica::africa
sacconi::fog
independientemente::irrespective
forzar::force
actores::commit
competencia::competition
motivo::reason
plazca::blanche
movimiento::movement
desempleados::unemployed
cuenta::account
altas::jobs
perfil::profile
coches::heard
omnipresente::screen
comercia::girls
noche::night
imposible::impossible
físicas::traditionally
extradición::symeou
comercio::trade
conocidos::marketplace
aumentará::upsurge
acaso::total
problema::problem
respalda::fortuyn
böge::böge
línea::line
muchos::many
desacopladas::argue
nasa::installation
reúne::owners
ashton::baroness
reúno::convene
escogido::track
cargar::shoulder
cargas::refer
gana::fraudulent
estonios::plates
alumnos::teachers
junio::june
shanghai::landmass
cruje::creaking
empresas::companies
llevaron::mistake
agua::water
publicamos::tracing
dando::pulling
declaración::declaration
postura::rejecting
alentar::absurd
pondría::league
ejemplos::examples
esquí::alps
disponibilidad::engage
mirar::shoulders
logramos::montreal
respectivas::lasting
ganó::owed
conocimientos::knowledge
ocho::eight
vía::telephone
medieval::ages
capital::capital
recuperar::dozen
piensan::considerably
nazis::nazi
pública::public
público::public
iniciativa::initiative
aprehendidas::manchester
siguen::still
profesor::schoolteacher
reformarse::investors
constructivos::constructive
metro::württemberg
pertinente::aback
grandes::major
cianuro::cyanide
reivindicó::lowered
operacionales::optimistic
rigidez::this
timón::helm
kyi::aung
febrero::february
creado::created
motor::engine
pesar::despite
piedra::stone
creada::created
desaparecido::disappeared
dejar::trace
usa::percent
uso::use
bicicletas::customer
azerbaiyán::azerbaijan
salvaguardia::auspices
antiincendios::gdr
contentarse::intellectually
sumarse::derogation
molestias::great
ligeros::lightweights
revistas::rigorous
investigadores::researchers
parliament::session
concedido::temporarily
fuimos::ones
factor::factor
especialista::specialist
demuestra::shows
colección::embracing
niegan::refuse
diehl::firms
nariz::yellow
dignos::noteworthy
límite::extraordinary
parecería::misrepresent
reducido::percentage
reducida::wording
cierre::jeopardized
sentimientos::mixed
abiertas::doors
tal::perhaps
tan::so
surge::arises
otoño::autumn
humanitario::humanitarian
seguridad::safety
dudas::justified
importar::importing
brian::simpson
importan::imported
mayores::greatest
sólidos::foundation
astronautas::astronauts
sin::without
maternal::maternal
impulsivo::impulsive
gadafi::gaddafi
tahrir::buzek
abuso::offence
detectó::mattel
asilo::asylum
eritrea::observer
tenéis::choice
alcalde::mayor
emanuel::victor
expresión::expression
lluvia::rivers
avances::progress
referendo::referendum
bajos::netherlands
síndrome::psychiatric
apoyó::hans
evolución::continually
discusiones::lots
superior::higher
roja::repeatedly
rojo::rear
convoca::chines
requiere::required
observador::lookout
muestran::fretting
material::material
practica::practices
encontraba::believed
materias::raw
dispuesta::ready
escuela::school
trae::unintended
inflige::inhumane
rumanía::romania
transfronterizos::transboundary
autobús::bus
jerusalén::jerusalem
firmaron::respectively
primas::raw
deberemos::clearer
duradera::lasting
interesadas::contractor
lograra::achieved
previsión::fiasco
apoyo::support
duradero::sustainable
examinamos::entrepreneurs
cautela::caution
influencia::influence
pacíficas::protests
respecta::viii
chimpancés::rescued
consideraba::considered
respecto::regard
conflicto::conflict
períodos::surveys
archivos::file
york::york
preparación::preparation
philip::respectively
trabajemos::starting
coherente::consistent
sorprendida::amazed
g::g
aprendido::lessons
hábito::smoking
civiles::civilians
gafas::markovic
después::after
moderación::sparingly
capacitados::prepared
demandas::demands
instalar::planned
echo::echo
fascinante::fascinating
aumentarán::stricter
contestarla::probably
infectadas::trends
explotarla::exploit
principios::beginning
encuesta::initiated
gratuitamente::passengers
explico::memory
mieses::actively
realidad::actually
rige::complied
custodia::custody
capaz::capable
astronomía::astronomy
contribuirán::contribute
concretar::perspective
basadas::concealing
relaciones::relations
aniversario::anniversary
sajarov::aung
apropiada::timely
colisión::collision
raíz::root
compren::talented
diariamente::receiving
apropiado::wants
oportuna::timely
oportuno::timely
destruirla::destroy
mencionadas::coms
francesas::sceptical
primeros::clogging
aportado::oostlander
sancionada::stands
hechos::facts
simplificación::simplifying
europea::european
sufragios::stations
europeo::european
jurídicamente::feeling
distrito::supervisory
licencia::tough
lugar::place
centra::focuses
clase::morals
centro::centre
especializadas::rigorous
profesionalidad::professionalising
contribuyen::passengers
çiller::tansu
adaptar::continually
fiel::parent
voluntarios::volunteers
trasladarnos::achievements
centímetros::centimetres
gradualmente::harms
dijo::said
enfrentamos::helpless
dejara::quit
dije::special
informada::markovic
presentando::white
debate::debate
informado::repeatedly
locas::shaken
respetado::counter
competitivas::advantages
interoperabilidad::chargers
facilitaría::improvement
pensar::reminded
echar::cable
confianza::confidence
positivos::positive
local::local
plazas::commemorate
vigor::force
firmado::signed
cuba::cuba
cubo::dustbin
trofeos::trophies
considerables::transposition
firmada::inadvertently
tierra::earth
públicos::public
administrativas::refer
vigilancia::surveillance
noruego::norwegian
noruega::norway
partir::recommended
provoca::understandable
modos::cold
aplicado::poppy
estadísticas::statistics
derramamiento::shed
aplicada::implemented
adolescentes::adolescents
puertas::dissolved
pesqueros::fisheries
playas::volunteers
favor::favour
circunvalación::definite
audiovisual::cable
drásticas::clamp
críticos::critical
previas::laid
addis::maputo
adicionalidad::additionality
enviado::urging
provocó::enquiry
renault::renault
asesinos::commemorate
conocido::known
prominente::prominent
deliberada::deliberately
proyecto::project
sencillo::simple
llegada::tbilisi
exploración::astronomy
tormenta::storm
himno::anthem
resuelto::solved
amigo::friend
faltan::lacking
modificará::granting
bbc::bbc
substitutivas::alternatives
señales::promising
sustancias::screening
expectativas::hallmarks
székely::representing
inundación::flooding
innatas::reliance
liverpool::serving
coche::car
actualmente::currently
salónica::mountainous
personalidades::personalities
distinción::distinction
escribir::write
cohesión::cohesion
consigan::dearest
fallido::mountainous
cursos::musicians
antigua::former
antiguo::met
acudir::table
poderes::restriction
sanguínea::recommended
vendedores::buyer
consiguiente::legislative
mutación::pigs
pesca::fisheries
ayudarlos::clearer
sociales::social
formulación::formulation
ambicioso::agenda
gasto::spending
pagando::ardenne
cine::fassbinder
gasta::burundi
asumido::assumed
falda::board
redactando::burmese
posición::position
añadido::prescribed
electricidad::electricity
osetia::reignite
autoadhesivo::matches
edimburgo::edinburgh
lobby::lobby
conflictos::clashes
profundidad::cm
escribió::wrote
aparte::journeys
tolera::tunisian
privado::private
especificidad::sporting
privada::private
dificultad::difficulty
acudió::turned
contribuciones::asking
gestión::management
patria::homeland
operaciones::transactions
introdujo::adolf
sufren::harassment
smith::smith
resultan::uranium
rezar::rightly
sonrisa::abd
resultar::becoming
arrojó::definite
precipitado::lightning
vistazo::cable
acuerdos::agreements
variante::flemish
precipitada::hurried
empaña::fog
presume::defeating
vehículos::vehicles
siglos::centuries
pagos::contract
avaros::businessmen
documentado::documented
incertidumbre::ignorance
cometer::organized
meles::officially
tardan::customary
dieron::ludicrous
respuestas::answers
pedofilia::paedophilia
castigar::punished
detenimiento::carefully
aclararlo::clarify
prohibirse::banned
británica::british
británico::british
obtendré::reply
pensaba::thought
consumidores::consumers
dirige::gaol
patatas::eurocents
pike::wealthy
movilidad::geographic
finalizara::participated
injusto::unfair
contrabando::smuggling
bronquitis::pneumonia
subido::fence
subida::flooding
funcionalista::functionalist
fomentar::encourage
demostró::counter
citas::here
aceptarlos::bothered
presiones::strain
constitución::constitution
relación::relationship
ocupados::entities
rechazar::laschet
van::discriminated
distinto::differs
examinará::libyan
continental::landmass
fraudes::hans
adelante::forward
rechazan::reject
explica::reasons
expresarse::assert
distintos::harassment
llevaría::engine
ofrecía::chance
jaffa::districts
habitantes::inhabitants
alternativos::shadow
luxemburgueses::lacking
tema::issue
temo::afraid
cambiarias::symptoms
ex::terrorists
negociar::negotiated
alcance::reach
incluirán::core
recomendarse::recommended
acudan::kashmir
profundamente::intimately
cincuenta::fifty
esperanzadoras::promising
pedazo::turkey
traducidas::translated
casos::cases
nacer::pneumonia
valorados::marketplace
provienen::areas
margaret::thatcher
modificación::respective
testimonios::testimonials
decirme::constituents
basados::underworld
previsible::predictable
fund::marshall
volumen::volume
impone::ages
felicitar::engage
heidi::yellow
demuestran::studies
